,awardYear,Persistence,awardLabel,PairID,class,lastPubYear,event,time,area,group
1,2008,11,Nobel Prize in Physiology or Medicine,24,Winners,2019,0,11,biology,Senior
2,1995,25,MacArthur Fellowship,25,Winners,2020,0,25,general,Middle
3,1987,23,Wolf Prize in Physics,172,Winners,2010,1,23,physics,Middle
4,2001,18,National Medal of Science,26,Winners,2019,0,18,general,Senior
5,2007,13,Fellow of the Royal Society,27,Winners,2020,0,13,general,Young
6,2002,17,MacArthur Fellowship,28,Winners,2019,0,17,general,Young
7,2009,10,National Medal of Science,173,Winners,2019,0,10,general,Senior
8,1894,30,Fellow of the Royal Society,174,Winners,1924,1,30,general,Young
9,2005,15,Fellow of the Royal Society,29,Winners,2020,0,15,general,Middle
10,2009,9,Shanti Swarup Bhatnagar Prize for Science and Technology,175,Winners,2018,0,9,general,Young
11,2013,7,Breakthrough Prize in Life Sciences,176,Winners,2020,0,7,biology,Senior
12,1992,28,Shanti Swarup Bhatnagar Prize for Science and Technology,177,Winners,2020,0,28,general,Young
13,2006,6,Shanti Swarup Bhatnagar Prize for Science and Technology,30,Winners,2012,1,6,general,Young
14,1991,29,Fellow of the Royal Society,178,Winners,2020,0,29,general,Middle
15,2004,16,Fellow of the Royal Society,31,Winners,2020,0,16,general,Middle
16,2015,5,Breakthrough Prize in Life Sciences,179,Winners,2020,0,5,biology,Young
17,1978,39,Nobel Prize in Physiology or Medicine,180,Winners,2017,1,39,biology,Middle
18,1991,29,MacArthur Fellowship,32,Winners,2020,0,29,general,Young
19,2008,12,Shanti Swarup Bhatnagar Prize for Science and Technology,181,Winners,2020,0,12,general,Young
20,1965,19,Nobel Prize in Physiology or Medicine,182,Winners,1984,1,19,biology,Senior
21,2016,4,Fellow of the Royal Society,33,Winners,2020,0,4,general,Senior
22,2015,5,Breakthrough Prize in Life Sciences,34,Winners,2020,0,5,biology,Middle
23,1987,27,Fellow of the Royal Society,183,Winners,2014,1,27,general,Middle
24,2012,8,Fellow of the Royal Society,184,Winners,2020,0,8,general,Middle
25,1992,28,MacArthur Fellowship,35,Winners,2020,0,28,general,Middle
26,1987,33,Nobel Prize in Physiology or Medicine,36,Winners,2020,0,33,biology,Middle
27,2016,4,Nobel Prize in Chemistry,185,Winners,2020,0,4,chemistry,Senior
28,2015,4,Wolf Prize in Medicine,186,Winners,2019,0,4,biology,Senior
29,2004,15,Nobel Prize in Chemistry,187,Winners,2019,0,15,chemistry,Middle
30,2017,2,Nobel Prize in Physics,188,Winners,2019,0,2,physics,Senior
31,2017,2,Breakthrough Prize in Life Sciences,37,Winners,2019,0,2,biology,Senior
32,1993,27,Willard Gibbs Award,189,Winners,2020,0,27,chemistry,Middle
33,1988,31,Fellow of the Royal Society,190,Winners,2019,0,31,general,Senior
34,1994,24,MacArthur Fellowship,191,Winners,2018,0,24,general,Young
35,2004,16,Fellow of the Royal Society,192,Winners,2020,0,16,general,Young
36,2016,4,Lasker-DeBakey Clinical Medical Research Award,193,Winners,2020,0,4,biology,Middle
37,2000,19,Fellow of the Royal Society,194,Winners,2019,0,19,general,Middle
38,2014,5,Willard Gibbs Award,195,Winners,2019,0,5,chemistry,Senior
39,1955,54,Nobel Prize in Physiology or Medicine,196,Winners,2009,1,54,biology,Middle
40,1982,37,Nobel Prize in Physiology or Medicine,197,Winners,2019,0,37,biology,Middle
41,1953,32,Nobel Prize in Physiology or Medicine,198,Winners,1985,1,32,biology,Middle
42,1972,32,Lasker-DeBakey Clinical Medical Research Award,199,Winners,2004,1,32,biology,Middle
43,1988,29,National Medal of Science,200,Winners,2017,1,29,general,Senior
44,1988,28,Fellow of the Royal Society,201,Winners,2016,1,28,general,Middle
45,1991,28,MacArthur Fellowship,202,Winners,2019,0,28,general,NA
46,2003,11,National Medal of Science,203,Winners,2014,1,11,general,Senior
47,2014,6,Fellow of the Royal Society,204,Winners,2020,0,6,general,Middle
48,1972,44,Nobel Prize in Physiology or Medicine,205,Winners,2016,1,44,biology,Young
49,2007,12,Fellow of the Royal Society,206,Winners,2019,0,12,general,Young
50,1978,42,Fields Medal,38,Winners,2020,0,42,mathematics,Young
51,1983,33,MacArthur Fellowship,39,Winners,2016,1,33,general,Young
53,1997,23,Fellow of the Royal Society,3,Winners,2020,0,23,general,Middle
54,2010,10,Fields Medal,40,Winners,2020,0,10,mathematics,Young
55,2014,6,Fellow of the Royal Society,41,Winners,2020,0,6,general,Middle
56,2005,15,Lyell Medal,208,Winners,2020,0,15,geography,Middle
57,1998,13,Lasker-DeBakey Clinical Medical Research Award,209,Winners,2011,1,13,biology,Senior
58,1931,39,Nobel Prize in Physiology or Medicine,210,Winners,1970,1,39,biology,Middle
59,2007,13,Bigsby Medal,211,Winners,2020,0,13,geography,Young
60,1992,2,National Medal of Science,212,Winners,1994,1,2,general,Senior
62,2010,10,Wolf Prize in Physics,214,Winners,2020,0,10,physics,Senior
63,1973,38,Nobel Prize in Physics,215,Winners,2011,1,38,physics,Young
64,2002,18,Fellow of the Royal Society,216,Winners,2020,0,18,general,Middle
65,1997,22,MacArthur Fellowship,217,Winners,2019,0,22,general,NA
66,2005,14,Wolf Prize in Physics,218,Winners,2019,0,14,physics,Senior
67,1999,17,Fellow of the Royal Society,42,Winners,2016,1,17,general,Middle
68,2008,12,Fellow of the Royal Society,219,Winners,2020,0,12,general,Young
69,1974,46,Fellow of the Royal Society,220,Winners,2020,0,46,general,Young
70,1994,16,National Medal of Science,221,Winners,2010,1,16,general,Senior
71,1954,34,Lasker-DeBakey Clinical Medical Research Award,222,Winners,1988,1,34,biology,Middle
72,1997,17,MacArthur Fellowship,223,Winners,2014,1,17,general,Middle
73,2010,8,Nobel Prize in Chemistry,224,Winners,2018,0,8,chemistry,Senior
74,2002,18,Fellow of the Royal Society,225,Winners,2020,0,18,general,Middle
75,2015,4,Fellow of the Royal Society,43,Winners,2019,0,4,general,Middle
76,2012,8,MacArthur Fellowship,4,Winners,2020,0,8,general,Young
77,1975,31,Fellow of the Royal Society,226,Winners,2006,1,31,general,Middle
78,1959,50,Nobel Prize in Physiology or Medicine,227,Winners,2009,1,50,biology,Young
79,2012,7,Turing Award,228,Winners,2019,0,7,cs,Middle
80,1996,23,Fellow of the Royal Society,229,Winners,2019,0,23,general,Young
81,1984,20,MacArthur Fellowship,230,Winners,2004,1,20,general,Middle
82,2009,11,Nobel Prize in Chemistry,44,Winners,2020,0,11,chemistry,Senior
83,2009,11,Nobel Prize in Physiology or Medicine,231,Winners,2020,0,11,biology,Middle
84,1986,29,Wolf Prize in Chemistry,232,Winners,2015,1,29,chemistry,Senior
85,1981,32,MacArthur Fellowship,45,Winners,2013,1,32,general,Young
86,2008,11,MacArthur Fellowship,233,Winners,2019,0,11,general,Young
87,2015,5,Nobel Prize in Physiology or Medicine,234,Winners,2020,0,5,biology,Senior
89,1995,22,Fellow of the Royal Society,236,Winners,2017,1,22,general,Middle
90,1978,24,Nobel Prize in Physiology or Medicine,5,Winners,2002,1,24,biology,Middle
91,2017,3,Fellow of the Royal Society,237,Winners,2020,0,3,general,NA
92,2003,16,Fellow of the Royal Society,238,Winners,2019,0,16,general,Middle
93,1996,24,Shanti Swarup Bhatnagar Prize for Science and Technology,239,Winners,2020,0,24,general,Young
94,1948,61,Fellow of the Royal Society,240,Winners,2009,1,61,general,Middle
95,1985,21,MacArthur Fellowship,46,Winners,2006,1,21,general,Young
96,1997,23,Shanti Swarup Bhatnagar Prize for Science and Technology,241,Winners,2020,0,23,general,Young
97,1971,38,Fellow of the Royal Society,242,Winners,2009,1,38,general,Middle
100,1987,32,National Medal of Science,245,Winners,2019,0,32,general,Senior
101,1995,20,Marconi Prize,246,Winners,2015,1,20,cs,Senior
102,2006,14,Fellow of the Royal Society,247,Winners,2020,0,14,general,NA
103,2002,15,Fields Medal,248,Winners,2017,1,15,mathematics,Young
104,1994,25,Fellow of the Royal Society,249,Winners,2019,0,25,general,Young
105,1986,33,Max Planck Medal,250,Winners,2019,0,33,physics,Middle
106,2001,18,Wolf Prize in Medicine,251,Winners,2019,0,18,biology,Senior
107,1962,47,Fellow of the Royal Society,252,Winners,2009,1,47,general,Young
108,1987,32,MacArthur Fellowship,253,Winners,2019,0,32,general,Senior
109,1999,21,Fellow of the Royal Society,254,Winners,2020,0,21,general,Young
110,2014,6,Fellow of the Royal Society,255,Winners,2020,0,6,general,Senior
111,2001,18,Fellow of the Royal Society,256,Winners,2019,0,18,general,Middle
112,2007,12,Hoover Medal,257,Winners,2019,0,12,cs,Middle
113,1982,18,Wollaston Medal,258,Winners,2000,1,18,geography,Middle
114,1994,26,Wolf Prize in Chemistry,259,Winners,2020,0,26,chemistry,Middle
115,2011,9,Shanti Swarup Bhatnagar Prize for Science and Technology,260,Winners,2020,0,9,general,Young
116,1947,36,Nobel Prize in Physiology or Medicine,261,Winners,1983,1,36,biology,Middle
117,2012,7,Wolf Prize in Mathematics,262,Winners,2019,0,7,mathematics,Senior
118,2001,13,National Medal of Science,263,Winners,2014,1,13,general,Senior
119,2007,13,Fellow of the Royal Society,47,Winners,2020,0,13,general,Middle
120,2015,5,Fellow of the Royal Society,264,Winners,2020,0,5,general,Senior
121,2010,9,Shanti Swarup Bhatnagar Prize for Science and Technology,265,Winners,2019,0,9,general,Young
122,1987,21,MacArthur Fellowship,266,Winners,2008,1,21,general,Young
123,1992,28,Fellow of the Royal Society,267,Winners,2020,0,28,general,Young
124,2016,4,Fellow of the Royal Society,268,Winners,2020,0,4,general,Middle
125,1994,26,Shanti Swarup Bhatnagar Prize for Science and Technology,269,Winners,2020,0,26,general,Young
126,2000,12,Fellow of the Royal Society,270,Winners,2012,1,12,general,Senior
127,2010,10,Fellow of the Royal Society,271,Winners,2020,0,10,general,Middle
128,2010,10,Fellow of the Royal Society,272,Winners,2020,0,10,general,Middle
129,1992,26,MacArthur Fellowship,273,Winners,2018,0,26,general,Middle
130,2014,6,Nobel Prize in Physiology or Medicine,274,Winners,2020,0,6,biology,Middle
131,1987,1,MacArthur Fellowship,275,Winners,1988,1,1,general,Senior
132,2007,13,Shanti Swarup Bhatnagar Prize for Science and Technology,276,Winners,2020,0,13,general,Young
133,1999,20,Nobel Prize in Physiology or Medicine,277,Winners,2019,0,20,biology,Senior
134,2000,19,MacArthur Fellowship,278,Winners,2019,0,19,general,Young
135,1998,22,Wolf Prize in Physics,48,Winners,2020,0,22,physics,Senior
136,1990,30,Fellow of the Royal Society,279,Winners,2020,0,30,general,Middle
137,2018,2,Breakthrough Prize in Life Sciences,280,Winners,2020,0,2,biology,Senior
138,2010,10,National Medal of Science,281,Winners,2020,0,10,general,Senior
139,1991,28,Fellow of the Royal Society,282,Winners,2019,0,28,general,Young
140,1983,13,National Medal of Science,283,Winners,1996,1,13,general,Senior
141,2013,7,Nobel Prize in Physiology or Medicine,284,Winners,2020,0,7,biology,Senior
142,2001,18,Shanti Swarup Bhatnagar Prize for Science and Technology,285,Winners,2019,0,18,general,Young
143,2018,2,Fellow of the Royal Society,286,Winners,2020,0,2,general,Senior
144,2015,5,Max Planck Medal,287,Winners,2020,0,5,physics,Middle
145,2004,15,Wolf Prize in Medicine,288,Winners,2019,0,15,biology,Middle
146,1974,39,Nobel Prize in Physiology or Medicine,289,Winners,2013,1,39,biology,Middle
147,1968,38,Nobel Prize in Physiology or Medicine,290,Winners,2006,1,38,biology,Middle
148,2006,14,Shanti Swarup Bhatnagar Prize for Science and Technology,291,Winners,2020,0,14,general,Young
149,1998,21,Wolf Prize in Medicine,292,Winners,2019,0,21,biology,Senior
151,2000,20,Fellow of the Royal Society,294,Winners,2020,0,20,general,Middle
152,2015,0,Vautrin Lud Prize,295,Winners,2015,1,0,geography,Senior
153,2014,6,Wolf Prize in Medicine,296,Winners,2020,0,6,biology,Senior
154,2003,17,Fellow of the Royal Society,297,Winners,2020,0,17,general,Senior
155,2015,4,Wolf Prize in Physics,298,Winners,2019,0,4,physics,Senior
156,1983,36,MacArthur Fellowship,299,Winners,2019,0,36,general,Young
157,1999,13,Fellow of the Royal Society,300,Winners,2012,1,13,general,Middle
158,1996,23,MacArthur Fellowship,301,Winners,2019,0,23,general,Young
159,1999,20,Shanti Swarup Bhatnagar Prize for Science and Technology,302,Winners,2019,0,20,general,Young
160,1965,45,Nobel Prize in Physiology or Medicine,303,Winners,2010,1,45,biology,Middle
161,1998,9,MacArthur Fellowship,304,Winners,2007,1,9,general,NA
162,2015,5,Shanti Swarup Bhatnagar Prize for Science and Technology,305,Winners,2020,0,5,general,Young
163,2013,7,MacArthur Fellowship,49,Winners,2020,0,7,general,Young
164,1972,21,Davy Medal,306,Winners,1993,1,21,chemistry,Middle
165,2001,10,National Medal of Science,307,Winners,2011,1,10,general,Senior
166,2017,3,Nobel Prize in Physics,308,Winners,2020,0,3,physics,Senior
167,2011,9,Shanti Swarup Bhatnagar Prize for Science and Technology,309,Winners,2020,0,9,general,Young
168,1964,30,Fellow of the Royal Society,310,Winners,1994,1,30,general,Middle
169,1995,25,Wolf Prize in Medicine,311,Winners,2020,0,25,biology,Middle
170,1974,42,Fellow of the Royal Society,312,Winners,2016,1,42,general,Middle
171,1987,33,MacArthur Fellowship,313,Winners,2020,0,33,general,Young
172,1971,49,Fellow of the Royal Society,314,Winners,2020,0,49,general,Young
173,2002,18,MacArthur Fellowship,315,Winners,2020,0,18,general,Young
174,1974,41,Fellow of the Royal Society,316,Winners,2015,1,41,general,Young
175,2016,4,Fellow of the Royal Society,317,Winners,2020,0,4,general,Senior
176,1992,10,Fellow of the Royal Society,318,Winners,2002,1,10,general,Young
177,2016,4,Fellow of the Royal Society,319,Winners,2020,0,4,general,Senior
178,2017,3,Fellow of the Royal Society,320,Winners,2020,0,3,general,Middle
179,1994,15,MacArthur Fellowship,321,Winners,2009,1,15,general,Senior
180,2015,4,Fellow of the Royal Society,322,Winners,2019,0,4,general,NA
181,2001,18,Nobel Prize in Physics,323,Winners,2019,0,18,physics,Middle
182,2000,20,Shanti Swarup Bhatnagar Prize for Science and Technology,324,Winners,2020,0,20,general,Young
183,1994,26,Willard Gibbs Award,325,Winners,2020,0,26,chemistry,Senior
184,2005,15,Shanti Swarup Bhatnagar Prize for Science and Technology,326,Winners,2020,0,15,general,Young
185,1996,24,Fellow of the Royal Society,327,Winners,2020,0,24,general,Middle
186,2005,15,Max Planck Medal,328,Winners,2020,0,15,physics,Middle
187,2006,14,Nobel Prize in Physics,329,Winners,2020,0,14,physics,Senior
188,2015,4,Fellow of the Royal Society,330,Winners,2019,0,4,general,Middle
189,1977,33,Fellow of the Royal Society,331,Winners,2010,1,33,general,Middle
190,2004,16,Nobel Prize in Physiology or Medicine,332,Winners,2020,0,16,biology,Middle
191,1990,30,MacArthur Fellowship,333,Winners,2020,0,30,general,Middle
192,2005,14,Fellow of the Royal Society,334,Winners,2019,0,14,general,Middle
193,1996,24,Fellow of the Royal Society,335,Winners,2020,0,24,general,Middle
194,2013,7,Fellow of the Royal Society,336,Winners,2020,0,7,general,Middle
195,2015,5,Fellow of the Royal Society,337,Winners,2020,0,5,general,Middle
196,1970,7,National Medal of Science,338,Winners,1977,1,7,general,Middle
197,2001,7,National Medal of Science,339,Winners,2008,1,7,general,Senior
198,1994,25,Fields Medal,340,Winners,2019,0,25,mathematics,Young
199,1997,16,Shanti Swarup Bhatnagar Prize for Science and Technology,341,Winners,2013,1,16,general,Young
200,1988,32,Fellow of the Royal Society,342,Winners,2020,0,32,general,Middle
201,1986,28,Fellow of the Royal Society,343,Winners,2014,1,28,general,Senior
202,2015,5,Fellow of the Royal Society,344,Winners,2020,0,5,general,Young
203,2009,10,Nobel Prize in Physiology or Medicine,345,Winners,2019,0,10,biology,Middle
204,2005,15,Fellow of the Royal Society,346,Winners,2020,0,15,general,Middle
205,2015,5,Fellow of the Royal Society,347,Winners,2020,0,5,general,Middle
206,1989,27,Fellow of the Royal Society,348,Winners,2016,1,27,general,Young
207,1981,34,Fellow of the Royal Society,349,Winners,2015,1,34,general,Middle
208,2007,11,Shanti Swarup Bhatnagar Prize for Science and Technology,350,Winners,2018,0,11,general,NA
209,2000,17,MacArthur Fellowship,351,Winners,2017,1,17,general,NA
210,2008,10,Fellow of the Royal Society,352,Winners,2018,0,10,general,Young
211,1990,2,National Medal of Science,353,Winners,1992,1,2,general,Senior
212,1984,2,MacArthur Fellowship,354,Winners,1986,1,2,general,Young
213,1953,49,Fellow of the Royal Society,355,Winners,2002,1,49,general,Young
214,2006,14,Fellow of the Royal Society,356,Winners,2020,0,14,general,Middle
215,1986,30,MacArthur Fellowship,357,Winners,2016,1,30,general,Young
216,2017,2,Fellow of the Royal Society,358,Winners,2019,0,2,general,Senior
217,2005,15,Nobel Prize in Chemistry,359,Winners,2020,0,15,chemistry,Senior
218,2004,12,Wolf Prize in Physics,360,Winners,2016,1,12,physics,Senior
219,1993,22,Fellow of the Royal Society,361,Winners,2015,1,22,general,Middle
220,1974,44,Fields Medal,362,Winners,2018,0,44,mathematics,Young
221,2015,5,Fellow of the Royal Society,363,Winners,2020,0,5,general,NA
222,1940,38,Fellow of the Royal Society,364,Winners,1978,1,38,general,Young
223,2012,6,MacArthur Fellowship,365,Winners,2018,0,6,general,Young
224,1986,33,Shanti Swarup Bhatnagar Prize for Science and Technology,366,Winners,2019,0,33,general,Young
225,2001,19,MacArthur Fellowship,367,Winners,2020,0,19,general,NA
226,2004,15,Fellow of the Royal Society,368,Winners,2019,0,15,general,Middle
227,1998,13,Nobel Prize in Physics,369,Winners,2011,1,13,physics,Middle
228,1983,35,Fellow of the Royal Society,370,Winners,2018,0,35,general,Young
229,2012,8,Fellow of the Royal Society,371,Winners,2020,0,8,general,Young
230,1974,39,Shanti Swarup Bhatnagar Prize for Science and Technology,372,Winners,2013,1,39,general,Young
231,2014,4,Fellow of the Royal Society,373,Winners,2018,0,4,general,Young
232,2017,2,Breakthrough Prize in Life Sciences,374,Winners,2019,0,2,biology,Senior
233,2009,9,Fellow of the Royal Society,375,Winners,2018,0,9,general,Senior
234,1994,25,Fellow of the Royal Society,376,Winners,2019,0,25,general,Middle
235,1994,24,Fellow of the Royal Society,377,Winners,2018,0,24,general,Young
236,1982,32,Lasker-DeBakey Clinical Medical Research Award,378,Winners,2014,1,32,biology,Middle
237,1964,38,Nobel Prize in Physics,379,Winners,2002,1,38,physics,Young
238,2007,13,Fellow of the Royal Society,380,Winners,2020,0,13,general,Middle
239,2000,20,MacArthur Fellowship,381,Winners,2020,0,20,general,Young
240,1987,30,Fellow of the Royal Society,382,Winners,2017,1,30,general,Middle
241,1996,24,Shanti Swarup Bhatnagar Prize for Science and Technology,383,Winners,2020,0,24,general,Young
242,1992,15,National Medal of Science,384,Winners,2007,1,15,general,Senior
243,2006,14,MacArthur Fellowship,385,Winners,2020,0,14,general,Young
244,2000,20,Shanti Swarup Bhatnagar Prize for Science and Technology,386,Winners,2020,0,20,general,NA
245,2007,13,Fellow of the Royal Society,387,Winners,2020,0,13,general,Middle
246,1945,62,Copley Medal,388,Winners,2007,1,62,general,Senior
247,2016,4,Shanti Swarup Bhatnagar Prize for Science and Technology,389,Winners,2020,0,4,general,Young
248,1956,40,Lasker-DeBakey Clinical Medical Research Award,390,Winners,1996,1,40,biology,Young
249,2013,5,Breakthrough Prize in Life Sciences,391,Winners,2018,0,5,biology,Senior
250,1958,23,Nobel Prize in Physiology or Medicine,392,Winners,1981,1,23,biology,Middle
251,1979,27,Fellow of the Royal Society,393,Winners,2006,1,27,general,Middle
252,1991,28,Fellow of the Royal Society,394,Winners,2019,0,28,general,Middle
253,2018,2,Fellow of the Royal Society,395,Winners,2020,0,2,general,Senior
254,1986,34,National Medal of Science,396,Winners,2020,0,34,general,Young
255,2008,12,Nobel Prize in Physiology or Medicine,397,Winners,2020,0,12,biology,Senior
256,2009,11,Fellow of the Royal Society,398,Winners,2020,0,11,general,Middle
257,1989,31,Fellow of the Royal Society,399,Winners,2020,0,31,general,Young
258,1993,27,Max Planck Medal,400,Winners,2020,0,27,physics,Middle
259,1993,25,Wolf Prize in Mathematics,401,Winners,2018,0,25,mathematics,Middle
260,1986,33,Nobel Prize in Chemistry,402,Winners,2019,0,33,chemistry,Middle
261,1966,7,Nobel Prize in Physics,403,Winners,1973,1,7,physics,Senior
262,1997,21,Shanti Swarup Bhatnagar Prize for Science and Technology,404,Winners,2018,0,21,general,Young
263,2016,4,Breakthrough Prize in Life Sciences,405,Winners,2020,0,4,biology,Young
264,2004,16,Nobel Prize in Physiology or Medicine,406,Winners,2020,0,16,biology,Middle
265,2010,10,National Medal of Science,407,Winners,2020,0,10,general,Senior
266,1994,17,Fellow of the Royal Society,408,Winners,2011,1,17,general,Young
267,1999,19,Fellow of the Royal Society,409,Winners,2018,0,19,general,Middle
268,2014,6,Fellow of the Royal Society,410,Winners,2020,0,6,general,Middle
269,1989,31,MacArthur Fellowship,411,Winners,2020,0,31,general,Middle
271,2002,6,Lasker-DeBakey Clinical Medical Research Award,413,Winners,2008,1,6,biology,Senior
272,1986,31,Fellow of the Royal Society,414,Winners,2017,1,31,general,Young
273,2016,4,Fellow of the Royal Society,415,Winners,2020,0,4,general,Senior
274,1992,27,MacArthur Fellowship,416,Winners,2019,0,27,general,Young
275,2011,9,Fellow of the Royal Society,417,Winners,2020,0,9,general,Middle
276,2000,20,Shanti Swarup Bhatnagar Prize for Science and Technology,418,Winners,2020,0,20,general,NA
277,2005,3,National Medal of Science,419,Winners,2008,1,3,general,Senior
278,1989,31,Fellow of the Royal Society,420,Winners,2020,0,31,general,Young
279,1996,24,Shanti Swarup Bhatnagar Prize for Science and Technology,421,Winners,2020,0,24,general,Young
280,2015,5,Breakthrough Prize in Life Sciences,422,Winners,2020,0,5,biology,Senior
281,1978,27,Turing Award,423,Winners,2005,1,27,cs,Young
282,1976,42,Hughes Medal,424,Winners,2018,0,42,physics,Young
283,2014,6,Fellow of the Royal Society,425,Winners,2020,0,6,general,Middle
284,2002,8,National Medal of Science,426,Winners,2010,1,8,general,Senior
285,1993,27,MacArthur Fellowship,427,Winners,2020,0,27,general,Middle
286,1956,60,Max Planck Medal,428,Winners,2016,1,60,physics,Middle
287,2009,11,Fellow of the Royal Society,429,Winners,2020,0,11,general,Middle
288,2016,4,Fellow of the Royal Society,430,Winners,2020,0,4,general,NA
289,2009,11,Shanti Swarup Bhatnagar Prize for Science and Technology,431,Winners,2020,0,11,general,Young
290,2008,12,MacArthur Fellowship,432,Winners,2020,0,12,general,Young
291,1988,23,Nobel Prize in Chemistry,433,Winners,2011,1,23,chemistry,Young
292,1998,18,National Medal of Science,434,Winners,2016,1,18,general,Senior
293,2007,12,Willard Gibbs Award,435,Winners,2019,0,12,chemistry,Middle
294,2007,12,Fellow of the Royal Society,436,Winners,2019,0,12,general,Senior
295,1982,38,MacArthur Fellowship,437,Winners,2020,0,38,general,Young
296,2009,11,Fellow of the Royal Society,438,Winners,2020,0,11,general,Middle
297,2017,3,Fellow of the Royal Society,439,Winners,2020,0,3,general,Senior
298,2002,18,Fellow of the Royal Society,440,Winners,2020,0,18,general,Middle
299,1993,27,Fellow of the Royal Society,441,Winners,2020,0,27,general,Young
300,2008,12,MacArthur Fellowship,442,Winners,2020,0,12,general,NA
301,2001,19,Fellow of the Royal Society,443,Winners,2020,0,19,general,Middle
302,2011,8,Nobel Prize in Physiology or Medicine,444,Winners,2019,0,8,biology,Senior
303,1984,29,Shanti Swarup Bhatnagar Prize for Science and Technology,445,Winners,2013,1,29,general,Young
304,2004,16,Shanti Swarup Bhatnagar Prize for Science and Technology,446,Winners,2020,0,16,general,Young
305,2008,12,Fellow of the Royal Society,447,Winners,2020,0,12,general,Middle
306,2009,7,Fellow of the Royal Society,448,Winners,2016,1,7,general,Senior
307,1990,30,Shanti Swarup Bhatnagar Prize for Science and Technology,449,Winners,2020,0,30,general,Young
308,2016,4,SASTRA Ramanujan Prize,50,Winners,2020,0,4,mathematics,Young
309,1999,13,Shanti Swarup Bhatnagar Prize for Science and Technology,450,Winners,2012,1,13,general,Young
310,1997,18,Fellow of the Royal Society,451,Winners,2015,1,18,general,Middle
311,2005,14,Fellow of the Royal Society,452,Winners,2019,0,14,general,Senior
312,1978,40,Fields Medal,453,Winners,2018,0,40,mathematics,Young
313,2011,8,Nobel Prize in Physics,454,Winners,2019,0,8,physics,Middle
314,2015,5,Fellow of the Royal Society,455,Winners,2020,0,5,general,NA
315,2005,15,Shanti Swarup Bhatnagar Prize for Science and Technology,456,Winners,2020,0,15,general,Young
316,2009,11,Fellow of the Royal Society,457,Winners,2020,0,11,general,Middle
317,2006,12,MacArthur Fellowship,458,Winners,2018,0,12,general,Middle
318,2014,5,Wolf Prize in Mathematics,459,Winners,2019,0,5,mathematics,Senior
319,1966,52,Fields Medal,460,Winners,2018,0,52,mathematics,Young
320,2017,3,Fellow of the Royal Society,461,Winners,2020,0,3,general,Senior
321,2008,12,MacArthur Fellowship,462,Winners,2020,0,12,general,Young
322,2015,5,Wolf Prize in Medicine,463,Winners,2020,0,5,biology,Senior
323,1987,33,MacArthur Fellowship,464,Winners,2020,0,33,general,Young
324,1998,20,Fellow of the Royal Society,465,Winners,2018,0,20,general,Middle
325,1998,22,Fields Medal,466,Winners,2020,0,22,mathematics,Young
326,1996,14,Willard Gibbs Award,467,Winners,2010,1,14,chemistry,Senior
327,2012,7,Shanti Swarup Bhatnagar Prize for Science and Technology,468,Winners,2019,0,7,general,Young
328,1984,32,Wolf Prize in Medicine,469,Winners,2016,1,32,biology,Middle
329,2006,14,Shanti Swarup Bhatnagar Prize for Science and Technology,470,Winners,2020,0,14,general,Young
330,2007,12,Shanti Swarup Bhatnagar Prize for Science and Technology,471,Winners,2019,0,12,general,Young
331,1981,30,Fellow of the Royal Society,472,Winners,2011,1,30,general,Middle
332,1995,24,Shanti Swarup Bhatnagar Prize for Science and Technology,473,Winners,2019,0,24,general,Young
333,1998,7,Fellow of the Royal Society,474,Winners,2005,1,7,general,Young
334,2009,11,Fellow of the Royal Society,475,Winners,2020,0,11,general,NA
335,1971,39,Shanti Swarup Bhatnagar Prize for Science and Technology,476,Winners,2010,1,39,general,Young
336,2004,16,Fellow of the Royal Society,477,Winners,2020,0,16,general,Middle
337,1977,34,Fellow of the Royal Society,478,Winners,2011,1,34,general,Young
338,1936,53,Fields Medal,479,Winners,1989,1,53,mathematics,Young
339,1977,36,Max Planck Medal,480,Winners,2013,1,36,physics,Middle
340,2002,15,MacArthur Fellowship,481,Winners,2017,1,15,general,Young
341,2001,19,National Medal of Science,482,Winners,2020,0,19,general,Senior
342,2006,13,Fields Medal,483,Winners,2019,0,13,mathematics,Young
343,1980,29,Wolf Prize in Medicine,484,Winners,2009,1,29,biology,Middle
344,2009,11,MacArthur Fellowship,485,Winners,2020,0,11,general,Middle
345,2013,6,Fellow of the Royal Society,486,Winners,2019,0,6,general,Middle
346,1993,12,National Medal of Science,487,Winners,2005,1,12,general,Senior
347,1991,28,Fellow of the Royal Society,488,Winners,2019,0,28,general,Young
348,2003,17,Fellow of the Royal Society,489,Winners,2020,0,17,general,Senior
349,2016,4,Fellow of the Royal Society,490,Winners,2020,0,4,general,Senior
351,1998,21,Fellow of the Royal Society,492,Winners,2019,0,21,general,Middle
352,2010,10,Fellow of the Royal Society,493,Winners,2020,0,10,general,Middle
353,1990,27,National Medal of Science,494,Winners,2017,1,27,general,Middle
354,1947,21,Fellow of the Royal Society,495,Winners,1968,1,21,general,Middle
355,2001,19,Fellow of the Royal Society,496,Winners,2020,0,19,general,Middle
356,2012,6,Wolf Prize in Chemistry,497,Winners,2018,0,6,chemistry,Middle
357,1990,13,Turing Award,498,Winners,2003,1,13,cs,Senior
358,1969,19,Nobel Prize in Physiology or Medicine,499,Winners,1988,1,19,biology,Middle
359,1966,41,Fellow of the Royal Society,500,Winners,2007,1,41,general,Middle
360,1989,25,National Medal of Science,501,Winners,2014,1,25,general,Middle
361,1989,31,Shanti Swarup Bhatnagar Prize for Science and Technology,502,Winners,2020,0,31,general,Young
362,2003,16,Fellow of the Royal Society,503,Winners,2019,0,16,general,Senior
363,1993,6,Fellow of the Royal Society,504,Winners,1999,1,6,general,Middle
364,1984,30,Fellow of the Royal Society,505,Winners,2014,1,30,general,Young
365,1984,35,Nobel Prize in Physics,506,Winners,2019,0,35,physics,Middle
366,2015,4,MacArthur Fellowship,507,Winners,2019,0,4,general,Young
367,1989,27,Turing Award,508,Winners,2016,1,27,cs,Middle
368,2011,9,Fellow of the Royal Society,509,Winners,2020,0,9,general,Middle
369,1991,27,Fellow of the Royal Society,510,Winners,2018,0,27,general,Senior
370,1999,21,Fellow of the Royal Society,511,Winners,2020,0,21,general,Middle
371,2013,1,Fellow of the Royal Society,512,Winners,2014,1,1,general,Senior
372,2004,14,Max Planck Medal,513,Winners,2018,0,14,physics,Senior
373,2015,3,Wolf Prize in Physics,514,Winners,2018,0,3,physics,Senior
374,2003,5,Max Planck Medal,515,Winners,2008,1,5,physics,Senior
375,2018,2,Fellow of the Royal Society,516,Winners,2020,0,2,general,Middle
376,1999,20,MacArthur Fellowship,517,Winners,2019,0,20,general,Young
377,2002,17,Fellow of the Royal Society,518,Winners,2019,0,17,general,Middle
378,1990,29,Fellow of the Royal Society,519,Winners,2019,0,29,general,NA
379,1995,15,Fellow of the Royal Society,520,Winners,2010,1,15,general,Senior
380,1978,40,Shanti Swarup Bhatnagar Prize for Science and Technology,521,Winners,2018,0,40,general,Young
381,1986,34,Shanti Swarup Bhatnagar Prize for Science and Technology,522,Winners,2020,0,34,general,NA
382,1980,40,Fellow of the Royal Society,523,Winners,2020,0,40,general,Young
383,1989,31,Fellow of the Royal Society,524,Winners,2020,0,31,general,Young
384,1983,35,Fellow of the Royal Society,525,Winners,2018,0,35,general,Middle
385,1987,33,MacArthur Fellowship,526,Winners,2020,0,33,general,Young
386,2002,17,Shanti Swarup Bhatnagar Prize for Science and Technology,527,Winners,2019,0,17,general,Young
387,2016,4,Fellow of the Royal Society,528,Winners,2020,0,4,general,NA
388,2015,4,Fellow of the Royal Society,529,Winners,2019,0,4,general,NA
389,2014,5,Wolf Prize in Medicine,530,Winners,2019,0,5,biology,Senior
390,1989,28,Fellow of the Royal Society,531,Winners,2017,1,28,general,Young
391,2016,4,Fellow of the Royal Society,532,Winners,2020,0,4,general,Young
392,1991,28,MacArthur Fellowship,533,Winners,2019,0,28,general,Middle
393,2011,9,National Medal of Science,534,Winners,2020,0,9,general,Senior
394,1990,20,Fellow of the Royal Society,535,Winners,2010,1,20,general,Middle
395,1982,37,MacArthur Fellowship,536,Winners,2019,0,37,general,Young
396,2017,3,Fellow of the Royal Society,537,Winners,2020,0,3,general,Senior
397,1996,24,Fellow of the Royal Society,538,Winners,2020,0,24,general,Middle
398,2009,11,Fellow of the Royal Society,539,Winners,2020,0,11,general,NA
399,2013,7,Shanti Swarup Bhatnagar Prize for Science and Technology,540,Winners,2020,0,7,general,Young
400,2013,7,National Medal of Science,541,Winners,2020,0,7,general,Middle
401,1983,27,Fellow of the Royal Society,542,Winners,2010,1,27,general,Middle
402,2010,6,Fields Medal,543,Winners,2016,1,6,mathematics,Young
403,1990,30,Fellow of the Royal Society,544,Winners,2020,0,30,general,Middle
404,1990,29,MacArthur Fellowship,545,Winners,2019,0,29,general,Middle
405,2002,18,Fellow of the Royal Society,546,Winners,2020,0,18,general,Middle
406,1991,28,MacArthur Fellowship,547,Winners,2019,0,28,general,Young
407,1994,20,Fellow of the Royal Society,548,Winners,2014,1,20,general,Middle
408,2016,4,Fellow of the Royal Society,549,Winners,2020,0,4,general,Senior
409,2007,13,Fellow of the Royal Society,550,Winners,2020,0,13,general,NA
410,2011,7,National Medal of Science,551,Winners,2018,0,7,general,Senior
411,1988,4,National Medal of Science,552,Winners,1992,1,4,general,Senior
412,1987,32,Fellow of the Royal Society,553,Winners,2019,0,32,general,Middle
413,2006,14,Shanti Swarup Bhatnagar Prize for Science and Technology,554,Winners,2020,0,14,general,Young
414,2017,3,Fellow of the Royal Society,555,Winners,2020,0,3,general,NA
415,2017,2,Fellow of the Royal Society,556,Winners,2019,0,2,general,Senior
416,1992,27,Fellow of the Royal Society,557,Winners,2019,0,27,general,Middle
417,2007,13,Fellow of the Royal Society,558,Winners,2020,0,13,general,Middle
418,1960,12,Fellow of the Royal Society,559,Winners,1972,1,12,general,Young
419,2008,12,Fellow of the Royal Society,560,Winners,2020,0,12,general,Middle
420,1952,17,Fellow of the Royal Society,561,Winners,1969,1,17,general,Young
421,1983,36,Shanti Swarup Bhatnagar Prize for Science and Technology,562,Winners,2019,0,36,general,Young
422,1990,15,National Medal of Science,563,Winners,2005,1,15,general,Senior
423,2004,16,MacArthur Fellowship,564,Winners,2020,0,16,general,Young
424,1998,21,Wolf Prize in Medicine,565,Winners,2019,0,21,biology,Senior
425,2008,12,Turing Award,566,Winners,2020,0,12,cs,Senior
426,2008,12,Shanti Swarup Bhatnagar Prize for Science and Technology,567,Winners,2020,0,12,general,Young
427,2001,19,Fellow of the Royal Society,568,Winners,2020,0,19,general,Middle
428,2013,7,Fellow of the Royal Society,569,Winners,2020,0,7,general,Middle
429,2016,3,MacArthur Fellowship,570,Winners,2019,0,3,general,Young
430,1992,28,Fellow of the Royal Society,571,Winners,2020,0,28,general,Middle
431,2000,18,Turing Award,572,Winners,2018,0,18,cs,Middle
432,1984,25,Nobel Prize in Chemistry,573,Winners,2009,1,25,chemistry,Senior
433,2002,18,MacArthur Fellowship,574,Winners,2020,0,18,general,Young
435,2017,3,Fellow of the Royal Society,576,Winners,2020,0,3,general,NA
436,1981,24,Nobel Prize in Physics,577,Winners,2005,1,24,physics,Senior
437,1982,36,Shanti Swarup Bhatnagar Prize for Science and Technology,578,Winners,2018,0,36,general,Young
438,1983,36,MacArthur Fellowship,51,Winners,2019,0,36,general,Middle
439,2000,9,Nobel Prize in Chemistry,579,Winners,2009,1,9,chemistry,Senior
440,1923,87,Fellow of the Royal Society,580,Winners,2010,1,87,general,Young
441,2008,12,Fellow of the Royal Society,581,Winners,2020,0,12,general,Senior
442,1954,49,Fellow of the Royal Society,582,Winners,2003,1,49,general,Young
443,1984,30,Fellow of the Royal Society,583,Winners,2014,1,30,general,Middle
444,2004,16,Shanti Swarup Bhatnagar Prize for Science and Technology,584,Winners,2020,0,16,general,Young
445,2014,5,Fields Medal,585,Winners,2019,0,5,mathematics,Young
446,1993,27,Shanti Swarup Bhatnagar Prize for Science and Technology,586,Winners,2020,0,27,general,Young
447,2003,17,Lasker-DeBakey Clinical Medical Research Award,587,Winners,2020,0,17,biology,Middle
448,1983,9,Fellow of the Royal Society,588,Winners,1992,1,9,general,Senior
449,2006,1,Wolf Prize in Chemistry,589,Winners,2007,1,1,chemistry,Senior
450,2018,2,Breakthrough Prize in Life Sciences,590,Winners,2020,0,2,biology,Senior
451,1990,18,National Medal of Science,591,Winners,2008,1,18,general,Senior
452,1982,35,Lasker-DeBakey Clinical Medical Research Award,592,Winners,2017,1,35,biology,Middle
453,1981,39,Nobel Prize in Chemistry,593,Winners,2020,0,39,chemistry,Senior
454,2010,10,Shanti Swarup Bhatnagar Prize for Science and Technology,594,Winners,2020,0,10,general,Young
455,1986,32,MacArthur Fellowship,595,Winners,2018,0,32,general,Young
456,1989,31,Shanti Swarup Bhatnagar Prize for Science and Technology,596,Winners,2020,0,31,general,Young
457,1999,11,National Medal of Science,597,Winners,2010,1,11,general,Senior
458,1997,23,Lasker-DeBakey Clinical Medical Research Award,598,Winners,2020,0,23,biology,Middle
459,2006,14,Fellow of the Royal Society,599,Winners,2020,0,14,general,Young
460,1997,23,MacArthur Fellowship,600,Winners,2020,0,23,general,Young
461,2018,1,Fellow of the Royal Society,601,Winners,2019,0,1,general,Middle
462,1995,25,Fellow of the Royal Society,602,Winners,2020,0,25,general,Middle
463,2016,4,Shanti Swarup Bhatnagar Prize for Science and Technology,603,Winners,2020,0,4,general,NA
464,2003,7,Lasker-DeBakey Clinical Medical Research Award,604,Winners,2010,1,7,biology,Senior
465,2014,5,Fields Medal,605,Winners,2019,0,5,mathematics,Young
466,2016,4,Fellow of the Royal Society,606,Winners,2020,0,4,general,Middle
467,2018,2,Fellow of the Royal Society,607,Winners,2020,0,2,general,Senior
468,2016,4,Fellow of the Royal Society,608,Winners,2020,0,4,general,NA
469,1999,21,Fellow of the Royal Society,609,Winners,2020,0,21,general,Middle
470,1993,27,Shanti Swarup Bhatnagar Prize for Science and Technology,610,Winners,2020,0,27,general,Young
471,1997,23,Fellow of the Royal Society,611,Winners,2020,0,23,general,Middle
472,1998,22,Fellow of the Royal Society,612,Winners,2020,0,22,general,Young
473,1987,31,MacArthur Fellowship,613,Winners,2018,0,31,general,Middle
474,1959,47,Nobel Prize in Physiology or Medicine,614,Winners,2006,1,47,biology,Middle
475,1979,41,Fellow of the Royal Society,615,Winners,2020,0,41,general,Young
476,2002,18,Fellow of the Royal Society,616,Winners,2020,0,18,general,Middle
477,2009,1,Turing Award,617,Winners,2010,1,1,cs,Senior
478,1995,13,National Medal of Science,618,Winners,2008,1,13,general,Senior
479,2004,16,Fellow of the Royal Society,619,Winners,2020,0,16,general,Middle
480,1961,54,Albert Einstein Award,620,Winners,2015,1,54,physics,Middle
481,1987,13,Fellow of the Royal Society,621,Winners,2000,1,13,general,Middle
483,2008,12,Shanti Swarup Bhatnagar Prize for Science and Technology,623,Winners,2020,0,12,general,Young
484,2018,2,Breakthrough Prize in Life Sciences,624,Winners,2020,0,2,biology,Middle
485,1994,25,Fellow of the Royal Society,52,Winners,2019,0,25,general,Middle
486,1995,25,Nobel Prize in Chemistry,625,Winners,2020,0,25,chemistry,Middle
487,1991,9,MacArthur Fellowship,626,Winners,2000,1,9,general,Senior
488,1985,35,MacArthur Fellowship,627,Winners,2020,0,35,general,Young
489,1981,36,Fellow of the Royal Society,628,Winners,2017,1,36,general,Middle
490,1978,41,Fellow of the Royal Society,629,Winners,2019,0,41,general,Young
491,2000,18,Nobel Prize in Physics,630,Winners,2018,0,18,physics,Senior
492,2006,2,Turing Award,631,Winners,2008,1,2,cs,Senior
493,2017,2,Wolf Prize in Physics,632,Winners,2019,0,2,physics,Senior
494,1991,20,National Medal of Science,633,Winners,2011,1,20,general,Senior
495,2010,10,Shanti Swarup Bhatnagar Prize for Science and Technology,634,Winners,2020,0,10,general,Young
496,1910,36,Fellow of the Royal Society,635,Winners,1946,1,36,general,Young
497,1996,24,MacArthur Fellowship,636,Winners,2020,0,24,general,Young
498,2000,19,Nobel Prize in Chemistry,637,Winners,2019,0,19,chemistry,Senior
499,1989,29,Edison Medal,638,Winners,2018,0,29,cs,Senior
500,1988,31,MacArthur Fellowship,639,Winners,2019,0,31,general,Young
501,1993,27,Shanti Swarup Bhatnagar Prize for Science and Technology,640,Winners,2020,0,27,general,Young
502,2000,11,National Medal of Science,641,Winners,2011,1,11,general,Senior
503,1967,14,Fellow of the Royal Society,642,Winners,1981,1,14,general,Senior
504,2001,19,Fellow of the Royal Society,643,Winners,2020,0,19,general,NA
505,2011,8,National Medal of Science,644,Winners,2019,0,8,general,Senior
506,2013,7,Fellow of the Royal Society,645,Winners,2020,0,7,general,Middle
507,2011,5,Marconi Prize,646,Winners,2016,1,5,cs,Senior
509,2013,7,MacArthur Fellowship,648,Winners,2020,0,7,general,Senior
510,2007,12,Fellow of the Royal Society,649,Winners,2019,0,12,general,Senior
511,1982,18,Shanti Swarup Bhatnagar Prize for Science and Technology,650,Winners,2000,1,18,general,Young
512,2011,9,MacArthur Fellowship,651,Winners,2020,0,9,general,Young
513,2001,10,Cullum Geographical Medal,652,Winners,2011,1,10,geography,Senior
515,2007,13,Turing Award,654,Winners,2020,0,13,cs,Senior
516,1951,43,Albert Einstein Award,655,Winners,1994,1,43,physics,Young
517,2005,11,Fellow of the Royal Society,656,Winners,2016,1,11,general,Middle
518,1987,4,Fellow of the Royal Society,657,Winners,1991,1,4,general,Senior
519,2001,18,Fellow of the Royal Society,658,Winners,2019,0,18,general,Middle
521,2017,3,Fellow of the Royal Society,660,Winners,2020,0,3,general,Middle
522,1982,38,Fields Medal,661,Winners,2020,0,38,mathematics,Young
523,1992,12,National Medal of Science,662,Winners,2004,1,12,general,Senior
524,2005,15,Shanti Swarup Bhatnagar Prize for Science and Technology,663,Winners,2020,0,15,general,Young
525,1994,25,Fellow of the Royal Society,664,Winners,2019,0,25,general,Young
526,2006,11,National Medal of Science,665,Winners,2017,1,11,general,Senior
527,1984,6,Nobel Prize in Physics,666,Winners,1990,1,6,physics,Middle
528,1971,39,Fellow of the Royal Society,667,Winners,2010,1,39,general,Young
529,2005,14,Shanti Swarup Bhatnagar Prize for Science and Technology,668,Winners,2019,0,14,general,NA
530,1944,65,Fellow of the Royal Society,669,Winners,2009,1,65,general,Middle
531,2009,11,Lasker-DeBakey Clinical Medical Research Award,670,Winners,2020,0,11,biology,Middle
532,2005,15,MacArthur Fellowship,671,Winners,2020,0,15,general,Young
533,2018,2,Bigsby Medal,672,Winners,2020,0,2,geography,NA
534,1974,37,National Medal of Science,673,Winners,2011,1,37,general,Senior
535,2002,17,Max Planck Medal,674,Winners,2019,0,17,physics,Senior
536,2007,11,MacArthur Fellowship,675,Winners,2018,0,11,general,NA
537,1989,9,National Medal of Science,676,Winners,1998,1,9,general,Senior
538,1992,25,Nobel Prize in Physiology or Medicine,677,Winners,2017,1,25,biology,Senior
539,2006,13,Nobel Prize in Physics,678,Winners,2019,0,13,physics,Middle
540,1985,34,Shanti Swarup Bhatnagar Prize for Science and Technology,679,Winners,2019,0,34,general,Young
541,2011,9,MacArthur Fellowship,680,Winners,2020,0,9,general,Young
542,2004,16,Edison Medal,681,Winners,2020,0,16,cs,Middle
543,1967,43,Nobel Prize in Chemistry,682,Winners,2010,1,43,chemistry,Young
544,2011,9,National Medal of Science,683,Winners,2020,0,9,general,Senior
545,1964,27,Fellow of the Royal Society,684,Winners,1991,1,27,general,Middle
546,2006,7,MacArthur Fellowship,685,Winners,2013,1,7,general,Young
547,2011,8,Nobel Prize in Physiology or Medicine,686,Winners,2019,0,8,biology,Senior
548,1994,26,Shanti Swarup Bhatnagar Prize for Science and Technology,687,Winners,2020,0,26,general,Young
549,2001,18,Fellow of the Royal Society,688,Winners,2019,0,18,general,Middle
550,1957,63,Nobel Prize in Physics,689,Winners,2020,0,63,physics,Young
551,2001,17,MacArthur Fellowship,690,Winners,2018,0,17,general,Middle
552,2010,10,Fellow of the Royal Society,691,Winners,2020,0,10,general,Middle
553,1985,34,Fellow of the Royal Society,692,Winners,2019,0,34,general,Young
554,1983,28,Fellow of the Royal Society,693,Winners,2011,1,28,general,Middle
555,2001,18,National Medal of Science,694,Winners,2019,0,18,general,Senior
556,2014,6,Fellow of the Royal Society,695,Winners,2020,0,6,general,Middle
557,1972,43,Fellow of the Royal Society,696,Winners,2015,1,43,general,Middle
558,1991,29,Shanti Swarup Bhatnagar Prize for Science and Technology,697,Winners,2020,0,29,general,Young
559,1997,23,MacArthur Fellowship,698,Winners,2020,0,23,general,Young
560,1969,44,Fellow of the Royal Society,699,Winners,2013,1,44,general,Young
561,2012,7,National Medal of Science,700,Winners,2019,0,7,general,Senior
562,1964,42,National Medal of Science,701,Winners,2006,1,42,general,Middle
563,1992,26,Fellow of the Royal Society,702,Winners,2018,0,26,general,Middle
564,1982,32,Fellow of the Royal Society,703,Winners,2014,1,32,general,Middle
565,1993,23,Fellow of the Royal Society,704,Winners,2016,1,23,general,Middle
566,2014,5,Abel Prize,705,Winners,2019,0,5,mathematics,Senior
567,1901,37,Fellow of the Royal Society,706,Winners,1938,1,37,general,Young
568,2015,4,Fellow of the Royal Society,707,Winners,2019,0,4,general,Senior
569,1981,39,Shanti Swarup Bhatnagar Prize for Science and Technology,708,Winners,2020,0,39,general,Young
570,1990,17,Wolf Prize in Medicine,709,Winners,2007,1,17,biology,Senior
571,1992,25,Fellow of the Royal Society,710,Winners,2017,1,25,general,Middle
572,2017,2,Fellow of the Royal Society,711,Winners,2019,0,2,general,Senior
573,2007,12,Fellow of the Royal Society,712,Winners,2019,0,12,general,Senior
574,1966,11,Shanti Swarup Bhatnagar Prize for Science and Technology,713,Winners,1977,1,11,general,Young
575,2000,20,Shanti Swarup Bhatnagar Prize for Science and Technology,714,Winners,2020,0,20,general,NA
576,2017,3,Fellow of the Royal Society,715,Winners,2020,0,3,general,NA
577,1983,33,Shanti Swarup Bhatnagar Prize for Science and Technology,716,Winners,2016,1,33,general,Young
578,1981,39,MacArthur Fellowship,717,Winners,2020,0,39,general,Young
579,2015,5,Fellow of the Royal Society,718,Winners,2020,0,5,general,Senior
580,1999,21,MacArthur Fellowship,719,Winners,2020,0,21,general,NA
581,2000,20,Fellow of the Royal Society,720,Winners,2020,0,20,general,NA
582,1987,32,Shanti Swarup Bhatnagar Prize for Science and Technology,721,Winners,2019,0,32,general,Young
583,2007,7,Turing Award,722,Winners,2014,1,7,cs,Middle
584,2013,3,Wolf Prize in Mathematics,723,Winners,2016,1,3,mathematics,Senior
585,1991,29,MacArthur Fellowship,724,Winners,2020,0,29,general,Young
586,2008,11,Fellow of the Royal Society,725,Winners,2019,0,11,general,Middle
587,2000,20,Fellow of the Royal Society,726,Winners,2020,0,20,general,Young
588,2015,5,Fellow of the Royal Society,727,Winners,2020,0,5,general,Senior
589,1982,37,MacArthur Fellowship,728,Winners,2019,0,37,general,Young
590,1997,21,Fellow of the Royal Society,729,Winners,2018,0,21,general,Middle
591,2001,19,Nobel Prize in Physics,730,Winners,2020,0,19,physics,Young
592,1966,51,Fellow of the Royal Society,731,Winners,2017,1,51,general,Young
593,2006,14,Nobel Prize in Physiology or Medicine,732,Winners,2020,0,14,biology,Middle
594,1972,45,Fellow of the Royal Society,733,Winners,2017,1,45,general,Young
595,2002,18,Shanti Swarup Bhatnagar Prize for Science and Technology,734,Winners,2020,0,18,general,Middle
596,1998,22,Fellow of the Royal Society,735,Winners,2020,0,22,general,Young
597,2016,4,Shanti Swarup Bhatnagar Prize for Science and Technology,736,Winners,2020,0,4,general,Young
598,2013,7,Fellow of the Royal Society,737,Winners,2020,0,7,general,Young
599,2005,14,Fellow of the Royal Society,738,Winners,2019,0,14,general,Senior
600,2006,13,MacArthur Fellowship,739,Winners,2019,0,13,general,Young
601,1983,35,National Medal of Science,740,Winners,2018,0,35,general,Senior
602,2000,20,MacArthur Fellowship,741,Winners,2020,0,20,general,Young
603,2001,17,Nobel Prize in Physiology or Medicine,742,Winners,2018,0,17,biology,Middle
604,2008,12,MacArthur Fellowship,743,Winners,2020,0,12,general,Young
605,1938,22,Fellow of the Royal Society,744,Winners,1960,1,22,general,Young
606,1892,17,Fellow of the Royal Society,745,Winners,1909,1,17,general,Young
607,1975,23,Nobel Prize in Physiology or Medicine,746,Winners,1998,1,23,biology,Young
608,2012,8,Fellow of the Royal Society,747,Winners,2020,0,8,general,Middle
609,1983,37,MacArthur Fellowship,748,Winners,2020,0,37,general,Young
610,2001,9,Fellow of the Royal Society,749,Winners,2010,1,9,general,Middle
611,1997,13,National Medal of Science,750,Winners,2010,1,13,general,Senior
612,1967,30,Bigsby Medal,751,Winners,1997,1,30,geography,Young
613,1991,16,National Medal of Science,752,Winners,2007,1,16,general,Senior
614,2003,17,MacArthur Fellowship,753,Winners,2020,0,17,general,Young
615,1982,12,Wolf Prize in Chemistry,754,Winners,1994,1,12,chemistry,Middle
617,1963,47,Willard Gibbs Award,756,Winners,2010,1,47,chemistry,Middle
618,2006,14,Marconi Prize,757,Winners,2020,0,14,cs,Middle
619,1990,30,Fellow of the Royal Society,758,Winners,2020,0,30,general,Young
620,2013,7,Breakthrough Prize in Life Sciences,759,Winners,2020,0,7,biology,Middle
621,1990,30,Fellow of the Royal Society,760,Winners,2020,0,30,general,Young
622,2013,7,Shanti Swarup Bhatnagar Prize for Science and Technology,761,Winners,2020,0,7,general,NA
623,2010,9,National Medal of Science,762,Winners,2019,0,9,general,Senior
624,1987,18,Fellow of the Royal Society,763,Winners,2005,1,18,general,Senior
625,2018,2,Wolf Prize in Chemistry,764,Winners,2020,0,2,chemistry,Senior
626,1980,32,Wolf Prize in Physics,765,Winners,2012,1,32,physics,Young
627,2015,5,Fellow of the Royal Society,766,Winners,2020,0,5,general,NA
628,2000,20,Shanti Swarup Bhatnagar Prize for Science and Technology,767,Winners,2020,0,20,general,Young
629,2016,3,Fellow of the Royal Society,768,Winners,2019,0,3,general,NA
630,2017,3,Fellow of the Royal Society,769,Winners,2020,0,3,general,NA
631,1985,10,Edison Medal,770,Winners,1995,1,10,cs,Senior
632,2011,8,MacArthur Fellowship,771,Winners,2019,0,8,general,Young
633,2016,4,Fellow of the Royal Society,772,Winners,2020,0,4,general,Young
634,2016,3,Fellow of the Royal Society,773,Winners,2019,0,3,general,Middle
635,1930,89,Nobel Prize in Chemistry,774,Winners,2019,0,89,chemistry,Middle
636,2000,20,MacArthur Fellowship,775,Winners,2020,0,20,general,Young
637,1993,27,Nobel Prize in Physiology or Medicine,776,Winners,2020,0,27,biology,Middle
638,2004,16,Fellow of the Royal Society,777,Winners,2020,0,16,general,Middle
639,1990,22,Fellow of the Royal Society,778,Winners,2012,1,22,general,Middle
640,1970,33,Fields Medal,779,Winners,2003,1,33,mathematics,Young
641,1994,8,Wollaston Medal,780,Winners,2002,1,8,geography,Middle
642,2011,9,Shanti Swarup Bhatnagar Prize for Science and Technology,781,Winners,2020,0,9,general,Young
644,2012,8,Fellow of the Royal Society,783,Winners,2020,0,8,general,Middle
645,2011,8,Wolf Prize in Medicine,784,Winners,2019,0,8,biology,Middle
646,1999,20,Copley Medal,785,Winners,2019,0,20,general,Senior
647,2011,9,MacArthur Fellowship,786,Winners,2020,0,9,general,Young
648,2000,20,Fellow of the Royal Society,787,Winners,2020,0,20,general,Middle
649,1995,21,MacArthur Fellowship,788,Winners,2016,1,21,general,Young
650,2003,17,Fellow of the Royal Society,789,Winners,2020,0,17,general,Middle
652,2010,10,Shanti Swarup Bhatnagar Prize for Science and Technology,791,Winners,2020,0,10,general,Young
653,1997,22,MacArthur Fellowship,792,Winners,2019,0,22,general,Young
654,2001,19,Wolf Prize in Medicine,793,Winners,2020,0,19,biology,Middle
655,2008,12,Fellow of the Royal Society,794,Winners,2020,0,12,general,Middle
656,1993,15,Wollaston Medal,795,Winners,2008,1,15,geography,Senior
657,1983,30,Wolf Prize in Physics,796,Winners,2013,1,30,physics,Senior
658,1978,42,Shanti Swarup Bhatnagar Prize for Science and Technology,797,Winners,2020,0,42,general,Young
659,1972,47,Shanti Swarup Bhatnagar Prize for Science and Technology,798,Winners,2019,0,47,general,Young
660,2000,14,Nobel Prize in Physics,799,Winners,2014,1,14,physics,Senior
661,2007,12,Lasker-DeBakey Clinical Medical Research Award,800,Winners,2019,0,12,biology,Senior
662,1949,16,Lasker-DeBakey Clinical Medical Research Award,801,Winners,1965,1,16,biology,Senior
663,1989,31,MacArthur Fellowship,802,Winners,2020,0,31,general,Young
664,2016,4,Fellow of the Royal Society,803,Winners,2020,0,4,general,NA
665,2004,16,Fellow of the Royal Society,804,Winners,2020,0,16,general,Middle
666,1999,21,Fellow of the Royal Society,805,Winners,2020,0,21,general,Middle
667,1988,31,MacArthur Fellowship,806,Winners,2019,0,31,general,Young
668,1923,11,Willard Gibbs Award,807,Winners,1934,1,11,chemistry,Middle
669,2016,4,Shanti Swarup Bhatnagar Prize for Science and Technology,808,Winners,2020,0,4,general,Young
670,2002,17,Wolf Prize in Physics,809,Winners,2019,0,17,physics,Senior
671,2010,10,MacArthur Fellowship,810,Winners,2020,0,10,general,Young
672,1972,47,Nobel Prize in Physics,811,Winners,2019,0,47,physics,Young
673,1998,22,Shanti Swarup Bhatnagar Prize for Science and Technology,812,Winners,2020,0,22,general,Young
674,2009,10,Shanti Swarup Bhatnagar Prize for Science and Technology,813,Winners,2019,0,10,general,Young
675,1959,50,Shanti Swarup Bhatnagar Prize for Science and Technology,814,Winners,2009,1,50,general,Young
676,2014,6,Fellow of the Royal Society,53,Winners,2020,0,6,general,Middle
677,2008,9,Wolf Prize in Medicine,815,Winners,2017,1,9,biology,Senior
678,1987,33,Fellow of the Royal Society,816,Winners,2020,0,33,general,Young
679,2004,6,Shanti Swarup Bhatnagar Prize for Science and Technology,817,Winners,2010,1,6,general,Young
680,1977,26,Fellow of the Royal Society,818,Winners,2003,1,26,general,Young
682,2011,8,Fellow of the Royal Society,820,Winners,2019,0,8,general,Middle
683,2009,11,Fellow of the Royal Society,821,Winners,2020,0,11,general,Middle
684,2009,3,National Medal of Science,822,Winners,2012,1,3,general,Senior
685,1988,32,Nobel Prize in Chemistry,823,Winners,2020,0,32,chemistry,Young
686,1967,37,Albert Einstein Award,824,Winners,2004,1,37,physics,Young
687,2001,18,Shanti Swarup Bhatnagar Prize for Science and Technology,825,Winners,2019,0,18,general,Young
688,1993,25,Fellow of the Royal Society,826,Winners,2018,0,25,general,NA
689,2017,3,Fellow of the Royal Society,827,Winners,2020,0,3,general,Middle
690,1985,35,Fellow of the Royal Society,828,Winners,2020,0,35,general,Senior
691,2013,6,SASTRA Ramanujan Prize,829,Winners,2019,0,6,mathematics,Young
692,1989,31,National Medal of Science,830,Winners,2020,0,31,general,Senior
693,2002,15,Shanti Swarup Bhatnagar Prize for Science and Technology,831,Winners,2017,1,15,general,Young
694,2004,15,Fellow of the Royal Society,832,Winners,2019,0,15,general,Middle
695,1993,27,Fellow of the Royal Society,833,Winners,2020,0,27,general,Middle
696,2009,11,Fellow of the Royal Society,834,Winners,2020,0,11,general,Middle
697,2011,9,MacArthur Fellowship,835,Winners,2020,0,9,general,Young
698,1988,32,Wolf Prize in Chemistry,836,Winners,2020,0,32,chemistry,Middle
699,2001,19,Fellow of the Royal Society,837,Winners,2020,0,19,general,Middle
700,1996,23,Shanti Swarup Bhatnagar Prize for Science and Technology,838,Winners,2019,0,23,general,Young
701,1993,27,MacArthur Fellowship,839,Winners,2020,0,27,general,Middle
702,2013,7,MacArthur Fellowship,840,Winners,2020,0,7,general,Young
703,2007,13,MacArthur Fellowship,841,Winners,2020,0,13,general,Young
704,2003,17,Fellow of the Royal Society,842,Winners,2020,0,17,general,Middle
705,2002,17,Shanti Swarup Bhatnagar Prize for Science and Technology,843,Winners,2019,0,17,general,Young
706,2009,11,MacArthur Fellowship,844,Winners,2020,0,11,general,Young
707,1982,36,Shanti Swarup Bhatnagar Prize for Science and Technology,845,Winners,2018,0,36,general,Young
708,2009,11,Cullum Geographical Medal,846,Winners,2020,0,11,geography,Senior
709,2006,14,Fellow of the Royal Society,847,Winners,2020,0,14,general,NA
710,2008,12,Shanti Swarup Bhatnagar Prize for Science and Technology,848,Winners,2020,0,12,general,NA
711,1985,34,Fellow of the Royal Society,849,Winners,2019,0,34,general,Middle
712,1996,23,Fellow of the Royal Society,850,Winners,2019,0,23,general,Middle
713,1977,23,Shanti Swarup Bhatnagar Prize for Science and Technology,851,Winners,2000,1,23,general,Young
714,1999,21,Fellow of the Royal Society,852,Winners,2020,0,21,general,Middle
715,2011,9,Fellow of the Royal Society,853,Winners,2020,0,9,general,Senior
716,1992,14,National Medal of Science,854,Winners,2006,1,14,general,Senior
717,2006,14,Fellow of the Royal Society,855,Winners,2020,0,14,general,Middle
718,1967,40,Fellow of the Royal Society,856,Winners,2007,1,40,general,Young
719,1982,38,MacArthur Fellowship,857,Winners,2020,0,38,general,Middle
720,2008,12,National Medal of Science,858,Winners,2020,0,12,general,Senior
721,1987,22,Fellow of the Royal Society,859,Winners,2009,1,22,general,Middle
722,1973,44,Fellow of the Royal Society,860,Winners,2017,1,44,general,Young
723,2007,13,National Medal of Science,861,Winners,2020,0,13,general,Senior
724,2015,5,MacArthur Fellowship,862,Winners,2020,0,5,general,NA
725,1993,20,MacArthur Fellowship,863,Winners,2013,1,20,general,Young
726,1976,30,Fellow of the Royal Society,864,Winners,2006,1,30,general,Middle
727,1988,30,MacArthur Fellowship,865,Winners,2018,0,30,general,Young
728,2017,3,Fellow of the Royal Society,866,Winners,2020,0,3,general,Middle
729,1971,48,Fellow of the Royal Society,867,Winners,2019,0,48,general,Young
731,2002,17,Shanti Swarup Bhatnagar Prize for Science and Technology,869,Winners,2019,0,17,general,Young
732,1991,29,Wolf Prize in Chemistry,870,Winners,2020,0,29,chemistry,Middle
733,1983,32,MacArthur Fellowship,871,Winners,2015,1,32,general,Middle
734,1987,32,MacArthur Fellowship,872,Winners,2019,0,32,general,NA
735,2006,14,Fellow of the Royal Society,873,Winners,2020,0,14,general,Middle
736,1991,27,Nobel Prize in Physiology or Medicine,874,Winners,2018,0,27,biology,Middle
737,2015,5,Fellow of the Royal Society,875,Winners,2020,0,5,general,Middle
738,2014,6,Breakthrough Prize in Life Sciences,876,Winners,2020,0,6,biology,Senior
739,2012,7,Abel Prize,877,Winners,2019,0,7,mathematics,Senior
740,2005,14,Fellow of the Royal Society,878,Winners,2019,0,14,general,Senior
741,1980,38,Nobel Prize in Physics,879,Winners,2018,0,38,physics,Middle
742,1954,47,Fellow of the Royal Society,880,Winners,2001,1,47,general,Young
743,2010,8,Lyell Medal,881,Winners,2018,0,8,geography,Senior
744,1978,34,Fellow of the Royal Society,882,Winners,2012,1,34,general,Middle
745,1982,20,National Medal of Science,883,Winners,2002,1,20,general,Senior
746,1998,20,MacArthur Fellowship,884,Winners,2018,0,20,general,Young
747,1983,36,MacArthur Fellowship,885,Winners,2019,0,36,general,Young
748,1996,1,Nobel Prize in Physics,886,Winners,1997,1,1,physics,Middle
749,1998,18,Vautrin Lud Prize,887,Winners,2016,1,18,geography,Middle
750,1990,25,Shanti Swarup Bhatnagar Prize for Science and Technology,888,Winners,2015,1,25,general,Young
751,1998,21,Shanti Swarup Bhatnagar Prize for Science and Technology,889,Winners,2019,0,21,general,Young
752,2017,3,Fellow of the Royal Society,890,Winners,2020,0,3,general,NA
753,1981,33,Fellow of the Royal Society,891,Winners,2014,1,33,general,Middle
754,1934,9,Fellow of the Royal Society,892,Winners,1943,1,9,general,Middle
755,1951,57,Nobel Prize in Chemistry,893,Winners,2008,1,57,chemistry,Young
756,1994,25,Wolf Prize in Chemistry,894,Winners,2019,0,25,chemistry,Young
757,2006,14,Shanti Swarup Bhatnagar Prize for Science and Technology,895,Winners,2020,0,14,general,NA
758,1994,26,Fellow of the Royal Society,896,Winners,2020,0,26,general,Middle
760,1963,9,National Medal of Science,898,Winners,1972,1,9,general,Senior
761,1989,3,Willard Gibbs Award,899,Winners,1992,1,3,chemistry,Senior
762,2010,0,Wolf Prize in Medicine,900,Winners,2010,1,0,biology,Senior
763,2015,5,Fellow of the Royal Society,901,Winners,2020,0,5,general,Middle
764,1983,37,Fellow of the Royal Society,902,Winners,2020,0,37,general,Young
765,1997,23,Nobel Prize in Physics,903,Winners,2020,0,23,physics,Middle
766,1975,33,National Medal of Science,904,Winners,2008,1,33,general,Senior
767,2014,4,Nobel Prize in Physiology or Medicine,905,Winners,2018,0,4,biology,Senior
768,2016,4,Fellow of the Royal Society,906,Winners,2020,0,4,general,Middle
769,2017,3,Wollaston Medal,907,Winners,2020,0,3,geography,Middle
770,1992,20,MacArthur Fellowship,908,Winners,2012,1,20,general,Middle
771,2008,12,Fellow of the Royal Society,54,Winners,2020,0,12,general,Senior
772,1958,18,Nobel Prize in Physiology or Medicine,909,Winners,1976,1,18,biology,Middle
773,1962,30,Fellow of the Royal Society,910,Winners,1992,1,30,general,Young
774,1997,23,National Medal of Science,911,Winners,2020,0,23,general,Middle
775,1985,32,MacArthur Fellowship,912,Winners,2017,1,32,general,Young
776,1996,24,Fellow of the Royal Society,913,Winners,2020,0,24,general,Middle
777,2004,16,Fellow of the Royal Society,914,Winners,2020,0,16,general,Middle
778,1998,21,Fellow of the Royal Society,915,Winners,2019,0,21,general,Middle
779,2008,12,National Medal of Science,916,Winners,2020,0,12,general,Senior
780,2005,14,Fellow of the Royal Society,917,Winners,2019,0,14,general,Middle
781,2001,19,Max Planck Medal,918,Winners,2020,0,19,physics,Middle
782,2001,10,Wolf Prize in Mathematics,919,Winners,2011,1,10,mathematics,Senior
783,2010,9,Fields Medal,920,Winners,2019,0,9,mathematics,Young
784,2014,6,Nobel Prize in Physics,921,Winners,2020,0,6,physics,Middle
785,1988,31,Shanti Swarup Bhatnagar Prize for Science and Technology,922,Winners,2019,0,31,general,Young
786,2010,10,Shanti Swarup Bhatnagar Prize for Science and Technology,923,Winners,2020,0,10,general,Young
787,1976,43,Nobel Prize in Physics,924,Winners,2019,0,43,physics,Young
788,1995,21,MacArthur Fellowship,925,Winners,2016,1,21,general,Middle
789,1990,20,Shanti Swarup Bhatnagar Prize for Science and Technology,926,Winners,2010,1,20,general,Young
790,2007,12,Fellow of the Royal Society,927,Winners,2019,0,12,general,Middle
791,2009,11,National Medal of Science,928,Winners,2020,0,11,general,Middle
792,1992,27,MacArthur Fellowship,929,Winners,2019,0,27,general,Young
793,2016,2,Fellow of the Royal Society,930,Winners,2018,0,2,general,Middle
794,1994,22,Turing Award,931,Winners,2016,1,22,cs,Middle
795,1989,30,Shanti Swarup Bhatnagar Prize for Science and Technology,932,Winners,2019,0,30,general,Young
796,1993,27,Fellow of the Royal Society,933,Winners,2020,0,27,general,Middle
797,1920,89,Nobel Prize in Physiology or Medicine,934,Winners,2009,1,89,biology,Middle
798,2001,19,Willard Gibbs Award,935,Winners,2020,0,19,chemistry,Middle
799,1988,23,Wolf Prize in Mathematics,936,Winners,2011,1,23,mathematics,Senior
800,2005,15,Fellow of the Royal Society,937,Winners,2020,0,15,general,NA
801,2003,16,Shanti Swarup Bhatnagar Prize for Science and Technology,938,Winners,2019,0,16,general,Young
802,2013,7,Fellow of the Royal Society,939,Winners,2020,0,7,general,NA
803,1985,34,Nobel Prize in Physics,940,Winners,2019,0,34,physics,Young
804,2005,15,Fellow of the Royal Society,941,Winners,2020,0,15,general,Middle
805,1970,43,Max Planck Medal,942,Winners,2013,1,43,physics,Middle
806,1983,32,National Medal of Science,943,Winners,2015,1,32,general,Young
807,2014,6,Shanti Swarup Bhatnagar Prize for Science and Technology,944,Winners,2020,0,6,general,Young
808,1976,44,Fellow of the Royal Society,945,Winners,2020,0,44,general,Young
809,1943,76,Nobel Prize in Physiology or Medicine,946,Winners,2019,0,76,biology,Middle
810,2013,7,National Medal of Science,947,Winners,2020,0,7,general,Senior
811,2006,14,Fields Medal,948,Winners,2020,0,14,mathematics,Young
812,1986,29,Fellow of the Royal Society,949,Winners,2015,1,29,general,Middle
813,1986,33,MacArthur Fellowship,950,Winners,2019,0,33,general,Young
814,2001,18,National Medal of Science,951,Winners,2019,0,18,general,Senior
815,1998,17,Nobel Prize in Physics,952,Winners,2015,1,17,physics,Middle
816,2007,13,Fellow of the Royal Society,953,Winners,2020,0,13,general,Senior
817,2012,8,Shanti Swarup Bhatnagar Prize for Science and Technology,954,Winners,2020,0,8,general,Young
818,2010,9,Shanti Swarup Bhatnagar Prize for Science and Technology,955,Winners,2019,0,9,general,NA
819,2004,15,Shanti Swarup Bhatnagar Prize for Science and Technology,956,Winners,2019,0,15,general,Young
820,2012,8,Fellow of the Royal Society,957,Winners,2020,0,8,general,Young
821,1972,38,Shanti Swarup Bhatnagar Prize for Science and Technology,958,Winners,2010,1,38,general,Young
822,1981,39,MacArthur Fellowship,959,Winners,2020,0,39,general,Young
823,1990,22,Fellow of the Royal Society,960,Winners,2012,1,22,general,Middle
824,1985,34,Shanti Swarup Bhatnagar Prize for Science and Technology,961,Winners,2019,0,34,general,Young
825,2012,8,Fellow of the Royal Society,962,Winners,2020,0,8,general,Senior
826,2017,2,Fellow of the Royal Society,963,Winners,2019,0,2,general,Senior
827,2013,6,Fellow of the Royal Society,964,Winners,2019,0,6,general,Middle
828,2007,13,National Medal of Science,965,Winners,2020,0,13,general,Senior
829,2004,15,Fellow of the Royal Society,966,Winners,2019,0,15,general,Senior
830,1968,43,Fellow of the Royal Society,967,Winners,2011,1,43,general,Young
831,2007,13,Fellow of the Royal Society,968,Winners,2020,0,13,general,Senior
832,1988,31,Nobel Prize in Chemistry,969,Winners,2019,0,31,chemistry,Middle
833,2012,8,Wolf Prize in Medicine,970,Winners,2020,0,8,biology,Senior
834,2016,4,Fellow of the Royal Society,971,Winners,2020,0,4,general,Middle
835,2015,5,MacArthur Fellowship,972,Winners,2020,0,5,general,NA
836,1986,23,MacArthur Fellowship,973,Winners,2009,1,23,general,Middle
837,1992,25,Shanti Swarup Bhatnagar Prize for Science and Technology,974,Winners,2017,1,25,general,Young
838,1997,22,Fellow of the Royal Society,975,Winners,2019,0,22,general,Young
839,1972,5,Fellow of the Royal Society,976,Winners,1977,1,5,general,Middle
840,2003,16,MacArthur Fellowship,977,Winners,2019,0,16,general,Middle
841,2016,4,Wolf Prize in Medicine,978,Winners,2020,0,4,biology,Senior
842,1995,24,Shanti Swarup Bhatnagar Prize for Science and Technology,979,Winners,2019,0,24,general,Young
843,1991,21,Fellow of the Royal Society,980,Winners,2012,1,21,general,Young
844,2009,11,Willard Gibbs Award,981,Winners,2020,0,11,chemistry,Senior
845,1966,7,Lasker-DeBakey Clinical Medical Research Award,982,Winners,1973,1,7,biology,Senior
846,2014,6,Fields Medal,983,Winners,2020,0,6,mathematics,Young
847,1977,41,Fellow of the Royal Society,984,Winners,2018,0,41,general,Middle
848,2014,6,Fellow of the Royal Society,985,Winners,2020,0,6,general,Young
849,2001,17,Fellow of the Royal Society,986,Winners,2018,0,17,general,Middle
851,1998,22,MacArthur Fellowship,988,Winners,2020,0,22,general,Young
852,2014,6,Fellow of the Royal Society,989,Winners,2020,0,6,general,Senior
853,2007,12,Fellow of the Royal Society,990,Winners,2019,0,12,general,Middle
854,1979,24,Fellow of the Royal Society,991,Winners,2003,1,24,general,Middle
855,2003,13,Fellow of the Royal Society,992,Winners,2016,1,13,general,Middle
856,1991,28,Shanti Swarup Bhatnagar Prize for Science and Technology,993,Winners,2019,0,28,general,Young
857,1996,23,Lasker-DeBakey Clinical Medical Research Award,994,Winners,2019,0,23,biology,Senior
858,1970,34,Fellow of the Royal Society,995,Winners,2004,1,34,general,Senior
859,1993,26,Fellow of the Royal Society,996,Winners,2019,0,26,general,Young
860,1988,24,Fellow of the Royal Society,997,Winners,2012,1,24,general,Middle
861,1984,36,MacArthur Fellowship,998,Winners,2020,0,36,general,Young
862,2013,7,Fellow of the Royal Society,999,Winners,2020,0,7,general,Middle
863,2003,17,Shanti Swarup Bhatnagar Prize for Science and Technology,1000,Winners,2020,0,17,general,Young
864,2015,4,Fellow of the Royal Society,1001,Winners,2019,0,4,general,Middle
865,1999,20,Fellow of the Royal Society,1002,Winners,2019,0,20,general,Senior
866,1998,17,Lasker-DeBakey Clinical Medical Research Award,1003,Winners,2015,1,17,biology,Senior
867,2014,6,Breakthrough Prize in Life Sciences,1004,Winners,2020,0,6,biology,Senior
868,2006,13,Fellow of the Royal Society,1005,Winners,2019,0,13,general,Middle
869,1997,15,Fellow of the Royal Society,1006,Winners,2012,1,15,general,Middle
870,1981,0,National Medal of Science,1007,Winners,1981,1,0,general,Senior
871,1983,29,Wolf Prize in Chemistry,1008,Winners,2012,1,29,chemistry,Middle
872,2005,14,Vautrin Lud Prize,1009,Winners,2019,0,14,geography,Senior
873,2003,17,Shanti Swarup Bhatnagar Prize for Science and Technology,1010,Winners,2020,0,17,general,Middle
874,2004,16,Fellow of the Royal Society,1011,Winners,2020,0,16,general,Middle
875,2016,4,Fellow of the Royal Society,1012,Winners,2020,0,4,general,NA
876,2012,8,Shanti Swarup Bhatnagar Prize for Science and Technology,1013,Winners,2020,0,8,general,Senior
877,1993,27,MacArthur Fellowship,1014,Winners,2020,0,27,general,Young
878,2002,18,Shanti Swarup Bhatnagar Prize for Science and Technology,1015,Winners,2020,0,18,general,Young
879,1993,24,Fellow of the Royal Society,1016,Winners,2017,1,24,general,Middle
880,1995,21,Turing Award,1017,Winners,2016,1,21,cs,Middle
881,1983,21,Turing Award,1018,Winners,2004,1,21,cs,Young
882,2011,9,Max Planck Medal,1019,Winners,2020,0,9,physics,Senior
883,2015,5,Breakthrough Prize in Life Sciences,1020,Winners,2020,0,5,biology,Middle
884,1988,30,Fellow of the Royal Society,1021,Winners,2018,0,30,general,Middle
885,2011,9,Fellow of the Royal Society,1022,Winners,2020,0,9,general,NA
886,2002,17,Shanti Swarup Bhatnagar Prize for Science and Technology,1023,Winners,2019,0,17,general,Young
887,2017,3,Fellow of the Royal Society,1024,Winners,2020,0,3,general,Middle
888,1983,31,Fellow of the Royal Society,1025,Winners,2014,1,31,general,Middle
889,1963,23,Nobel Prize in Chemistry,1026,Winners,1986,1,23,chemistry,Senior
890,1986,21,Fellow of the Royal Society,1027,Winners,2007,1,21,general,Middle
891,2011,8,Shanti Swarup Bhatnagar Prize for Science and Technology,1028,Winners,2019,0,8,general,Young
892,1987,31,Shanti Swarup Bhatnagar Prize for Science and Technology,1029,Winners,2018,0,31,general,Young
893,2002,17,Fellow of the Royal Society,1030,Winners,2019,0,17,general,Middle
894,1976,38,Marconi Prize,1031,Winners,2014,1,38,cs,Middle
895,2007,13,Shanti Swarup Bhatnagar Prize for Science and Technology,1032,Winners,2020,0,13,general,NA
896,2002,17,Fellow of the Royal Society,1033,Winners,2019,0,17,general,Middle
897,1992,17,Nobel Prize in Physiology or Medicine,1034,Winners,2009,1,17,biology,Senior
898,2005,14,Willard Gibbs Award,1035,Winners,2019,0,14,chemistry,Senior
899,2014,5,Fellow of the Royal Society,1036,Winners,2019,0,5,general,NA
900,1979,40,Fellow of the Royal Society,1037,Winners,2019,0,40,general,Young
901,2004,15,MacArthur Fellowship,1038,Winners,2019,0,15,general,Young
902,2005,15,National Medal of Science,1039,Winners,2020,0,15,general,Middle
903,1903,72,Fellow of the Royal Society,1040,Winners,1975,1,72,general,Young
904,2007,13,Shanti Swarup Bhatnagar Prize for Science and Technology,1041,Winners,2020,0,13,general,Young
905,2017,2,Fellow of the Royal Society,1042,Winners,2019,0,2,general,NA
906,1990,10,National Medal of Science,1043,Winners,2000,1,10,general,Middle
907,2006,6,National Medal of Science,1044,Winners,2012,1,6,general,Senior
908,2014,6,Nobel Prize in Physiology or Medicine,1045,Winners,2020,0,6,biology,Middle
909,1992,7,Fellow of the Royal Society,1046,Winners,1999,1,7,general,Middle
910,2010,10,MacArthur Fellowship,1047,Winners,2020,0,10,general,Young
911,2009,11,Fellow of the Royal Society,1048,Winners,2020,0,11,general,Middle
912,1999,17,Fellow of the Royal Society,1049,Winners,2016,1,17,general,Middle
913,1992,28,Shanti Swarup Bhatnagar Prize for Science and Technology,1050,Winners,2020,0,28,general,Young
914,1993,27,Fellow of the Royal Society,1051,Winners,2020,0,27,general,Young
915,2017,3,Max Planck Medal,1052,Winners,2020,0,3,physics,Senior
916,2016,0,Vautrin Lud Prize,1053,Winners,2016,1,0,geography,Senior
917,2011,9,Fellow of the Royal Society,55,Winners,2020,0,9,general,Middle
918,1996,23,Turing Award,1054,Winners,2019,0,23,cs,Middle
919,2013,7,Fellow of the Royal Society,1055,Winners,2020,0,7,general,Middle
920,1990,25,Fellow of the Royal Society,1056,Winners,2015,1,25,general,Young
921,1991,26,National Medal of Science,1057,Winners,2017,1,26,general,Middle
922,1953,11,Nobel Prize in Chemistry,1058,Winners,1964,1,11,chemistry,Senior
923,1979,27,National Medal of Science,1059,Winners,2006,1,27,general,Middle
924,2006,14,Fellow of the Royal Society,1060,Winners,2020,0,14,general,Senior
925,1989,19,Fellow of the Royal Society,1061,Winners,2008,1,19,general,Middle
926,2010,9,Fellow of the Royal Society,1062,Winners,2019,0,9,general,Middle
928,1994,25,Fellow of the Royal Society,1064,Winners,2019,0,25,general,Young
929,1976,34,Fellow of the Royal Society,1065,Winners,2010,1,34,general,Middle
930,1966,1,Fellow of the Royal Society,1066,Winners,1967,1,1,general,Young
931,1981,38,Fellow of the Royal Society,1067,Winners,2019,0,38,general,Young
932,2012,7,Fellow of the Royal Society,1068,Winners,2019,0,7,general,Senior
933,2005,13,Fellow of the Royal Society,1069,Winners,2018,0,13,general,Middle
935,1994,25,Shanti Swarup Bhatnagar Prize for Science and Technology,1071,Winners,2019,0,25,general,Young
936,2013,3,Lasker-DeBakey Clinical Medical Research Award,1072,Winners,2016,1,3,biology,Senior
937,1973,33,National Medal of Science,1073,Winners,2006,1,33,general,Senior
938,1992,26,Edison Medal,1074,Winners,2018,0,26,cs,Middle
939,2002,9,Lasker-DeBakey Clinical Medical Research Award,1075,Winners,2011,1,9,biology,Senior
940,2016,4,Fellow of the Royal Society,1076,Winners,2020,0,4,general,Senior
941,2012,5,National Medal of Science,1077,Winners,2017,1,5,general,Senior
942,2012,8,Nobel Prize in Physics,1078,Winners,2020,0,8,physics,Senior
943,2005,15,Fellow of the Royal Society,1079,Winners,2020,0,15,general,Senior
944,1984,35,MacArthur Fellowship,1080,Winners,2019,0,35,general,Young
945,1970,39,Fellow of the Royal Society,1081,Winners,2009,1,39,general,Middle
946,1967,22,Shanti Swarup Bhatnagar Prize for Science and Technology,1082,Winners,1989,1,22,general,Young
947,2005,14,Fellow of the Royal Society,1083,Winners,2019,0,14,general,Middle
948,1987,30,Nobel Prize in Physics,1084,Winners,2017,1,30,physics,Young
949,1975,38,Shanti Swarup Bhatnagar Prize for Science and Technology,1085,Winners,2013,1,38,general,Young
950,2002,17,Wolf Prize in Medicine,56,Winners,2019,0,17,biology,Senior
951,1964,50,National Medal of Science,1086,Winners,2014,1,50,general,Middle
952,1985,28,Fellow of the Royal Society,1087,Winners,2013,1,28,general,Middle
953,2017,3,Nobel Prize in Physiology or Medicine,1088,Winners,2020,0,3,biology,Senior
954,2009,10,Fellow of the Royal Society,1089,Winners,2019,0,10,general,Middle
955,1999,20,Shanti Swarup Bhatnagar Prize for Science and Technology,1090,Winners,2019,0,20,general,Young
956,2002,17,Turing Award,1091,Winners,2019,0,17,cs,Middle
957,1992,6,MacArthur Fellowship,1092,Winners,1998,1,6,general,Middle
958,1985,33,Claude E. Shannon Award,1093,Winners,2018,0,33,cs,Middle
959,1983,32,Fellow of the Royal Society,1094,Winners,2015,1,32,general,Young
960,2018,1,Fellow of the Royal Society,1095,Winners,2019,0,1,general,NA
961,2004,16,Fellow of the Royal Society,1096,Winners,2020,0,16,general,Middle
962,2015,5,Fellow of the Royal Society,1097,Winners,2020,0,5,general,NA
963,2014,6,Shanti Swarup Bhatnagar Prize for Science and Technology,1098,Winners,2020,0,6,general,Young
964,1979,30,Fellow of the Royal Society,1099,Winners,2009,1,30,general,Middle
965,1986,33,Shanti Swarup Bhatnagar Prize for Science and Technology,1100,Winners,2019,0,33,general,Young
966,2017,3,Fellow of the Royal Society,1101,Winners,2020,0,3,general,Senior
967,2000,19,Fellow of the Royal Society,1102,Winners,2019,0,19,general,Middle
968,2009,11,Fellow of the Royal Society,57,Winners,2020,0,11,general,Young
969,2013,7,Nobel Prize in Physiology or Medicine,1103,Winners,2020,0,7,biology,Senior
970,1998,22,National Medal of Science,1104,Winners,2020,0,22,general,Senior
971,1962,57,Fellow of the Royal Society,1105,Winners,2019,0,57,general,Young
972,1998,19,Nobel Prize in Physics,1106,Winners,2017,1,19,physics,Middle
973,1973,42,Nobel Prize in Physics,1107,Winners,2015,1,42,physics,Middle
974,2009,11,MacArthur Fellowship,1108,Winners,2020,0,11,general,Young
975,1973,33,Fellow of the Royal Society,1109,Winners,2006,1,33,general,Young
976,2004,16,Fellow of the Royal Society,1110,Winners,2020,0,16,general,Senior
977,2004,10,National Medal of Science,1111,Winners,2014,1,10,general,Senior
978,1989,31,Shanti Swarup Bhatnagar Prize for Science and Technology,1112,Winners,2020,0,31,general,NA
979,1995,25,Wolf Prize in Physics,1113,Winners,2020,0,25,physics,Senior
980,2002,17,Fellow of the Royal Society,58,Winners,2019,0,17,general,Middle
981,1972,47,Fellow of the Royal Society,1114,Winners,2019,0,47,general,Young
982,2013,7,Fellow of the Royal Society,1115,Winners,2020,0,7,general,Middle
983,2015,5,Shanti Swarup Bhatnagar Prize for Science and Technology,1116,Winners,2020,0,5,general,Young
984,2004,16,Fellow of the Royal Society,1117,Winners,2020,0,16,general,Senior
985,1985,31,MacArthur Fellowship,1118,Winners,2016,1,31,general,Middle
986,2001,17,MacArthur Fellowship,1119,Winners,2018,0,17,general,Young
987,1999,14,National Medal of Science,1120,Winners,2013,1,14,general,Senior
988,2007,9,Copley Medal,1121,Winners,2016,1,9,general,Senior
989,1984,36,Fellow of the Royal Society,1122,Winners,2020,0,36,general,Middle
990,2007,13,SASTRA Ramanujan Prize,1123,Winners,2020,0,13,mathematics,Young
991,2000,18,Edison Medal,1124,Winners,2018,0,18,cs,Senior
992,2016,4,Lasker-DeBakey Clinical Medical Research Award,1125,Winners,2020,0,4,biology,Senior
993,1984,36,Fellow of the Royal Society,1126,Winners,2020,0,36,general,Young
996,2003,17,Fellow of the Royal Society,1129,Winners,2020,0,17,general,Middle
997,1989,30,Nobel Prize in Chemistry,1130,Winners,2019,0,30,chemistry,Middle
998,1986,34,National Medal of Science,1131,Winners,2020,0,34,general,Middle
999,1996,24,Nobel Prize in Physics,1132,Winners,2020,0,24,physics,Senior
1000,1987,33,MacArthur Fellowship,1133,Winners,2020,0,33,general,Middle
1002,1985,35,Fellow of the Royal Society,1135,Winners,2020,0,35,general,Middle
1003,1999,21,MacArthur Fellowship,1136,Winners,2020,0,21,general,Young
1004,2003,17,Fellow of the Royal Society,1137,Winners,2020,0,17,general,Middle
1005,2009,11,Fellow of the Royal Society,1138,Winners,2020,0,11,general,NA
1006,2006,12,Fellow of the Royal Society,1139,Winners,2018,0,12,general,Middle
1007,1989,18,Fellow of the Royal Society,1140,Winners,2007,1,18,general,Senior
1008,1982,38,Fields Medal,1141,Winners,2020,0,38,mathematics,Young
1009,1986,30,Fields Medal,1142,Winners,2016,1,30,mathematics,Young
1010,2007,10,Fellow of the Royal Society,1143,Winners,2017,1,10,general,NA
1011,2001,17,Fellow of the Royal Society,1144,Winners,2018,0,17,general,Senior
1012,1985,27,Fellow of the Royal Society,1145,Winners,2012,1,27,general,Middle
1013,1944,21,Fellow of the Royal Society,1146,Winners,1965,1,21,general,Young
1014,2015,4,Claude E. Shannon Award,1147,Winners,2019,0,4,cs,Senior
1015,1998,11,Shanti Swarup Bhatnagar Prize for Science and Technology,1148,Winners,2009,1,11,general,Young
1016,1982,38,Fellow of the Royal Society,1149,Winners,2020,0,38,general,Young
1017,2012,7,Max Planck Medal,1150,Winners,2019,0,7,physics,Middle
1018,1979,6,National Medal of Science,1151,Winners,1985,1,6,general,Middle
1019,2002,18,Fellow of the Royal Society,1152,Winners,2020,0,18,general,Middle
1020,2011,8,Shanti Swarup Bhatnagar Prize for Science and Technology,1153,Winners,2019,0,8,general,NA
1021,2008,11,Nobel Prize in Chemistry,1154,Winners,2019,0,11,chemistry,Senior
1022,1981,11,Wollaston Medal,1155,Winners,1992,1,11,geography,Senior
1023,1997,23,MacArthur Fellowship,1156,Winners,2020,0,23,general,Young
1024,1998,19,MacArthur Fellowship,1157,Winners,2017,1,19,general,Middle
1025,1942,19,Fellow of the Royal Society,1158,Winners,1961,1,19,general,Young
1026,1963,35,Fellow of the Royal Society,1159,Winners,1998,1,35,general,Young
1027,2015,5,MacArthur Fellowship,1160,Winners,2020,0,5,general,Young
1028,1994,25,Fellow of the Royal Society,1161,Winners,2019,0,25,general,Young
1029,2003,16,Shanti Swarup Bhatnagar Prize for Science and Technology,1162,Winners,2019,0,16,general,Young
1030,2003,17,Shanti Swarup Bhatnagar Prize for Science and Technology,1163,Winners,2020,0,17,general,Young
1031,2003,8,National Medal of Science,1164,Winners,2011,1,8,general,Senior
1032,2006,14,National Medal of Science,1165,Winners,2020,0,14,general,Senior
1033,2006,14,Shanti Swarup Bhatnagar Prize for Science and Technology,1166,Winners,2020,0,14,general,Young
1034,2006,14,Fellow of the Royal Society,1167,Winners,2020,0,14,general,Middle
1035,1994,26,Fellow of the Royal Society,1168,Winners,2020,0,26,general,Middle
1036,1996,23,MacArthur Fellowship,1169,Winners,2019,0,23,general,Young
1037,1985,26,Nobel Prize in Chemistry,1170,Winners,2011,1,26,chemistry,Senior
1038,1989,30,Fellow of the Royal Society,1171,Winners,2019,0,30,general,Middle
1039,2007,6,National Medal of Science,1172,Winners,2013,1,6,general,Senior
1040,2017,2,Fellow of the Royal Society,1173,Winners,2019,0,2,general,Senior
1041,1982,21,Fields Medal,1174,Winners,2003,1,21,mathematics,Young
1042,2014,5,Lasker-DeBakey Clinical Medical Research Award,1175,Winners,2019,0,5,biology,Senior
1043,1995,12,Fellow of the Royal Society,1176,Winners,2007,1,12,general,Senior
1044,1976,23,National Medal of Science,1177,Winners,1999,1,23,general,Senior
1045,1980,39,Nobel Prize in Chemistry,1178,Winners,2019,0,39,chemistry,Middle
1046,1973,17,National Medal of Science,1179,Winners,1990,1,17,general,Middle
1047,2011,9,Fellow of the Royal Society,1180,Winners,2020,0,9,general,Young
1048,1990,6,MacArthur Fellowship,1181,Winners,1996,1,6,general,Senior
1049,1995,25,Shanti Swarup Bhatnagar Prize for Science and Technology,1182,Winners,2020,0,25,general,Young
1050,1937,20,Hughes Medal,1183,Winners,1957,1,20,physics,Young
1051,1978,32,Fellow of the Royal Society,1184,Winners,2010,1,32,general,Middle
1052,1987,32,Fellow of the Royal Society,1185,Winners,2019,0,32,general,Young
1053,1972,40,Fellow of the Royal Society,1186,Winners,2012,1,40,general,Young
1054,1939,49,Fellow of the Royal Society,1187,Winners,1988,1,49,general,Young
1055,2009,10,Shanti Swarup Bhatnagar Prize for Science and Technology,1188,Winners,2019,0,10,general,Young
1056,1999,18,Fellow of the Royal Society,1189,Winners,2017,1,18,general,NA
1057,1937,72,Nobel Prize in Physiology or Medicine,1190,Winners,2009,1,72,biology,Young
1058,1985,35,MacArthur Fellowship,1191,Winners,2020,0,35,general,Middle
1059,1973,34,Shanti Swarup Bhatnagar Prize for Science and Technology,1192,Winners,2007,1,34,general,Young
1060,1996,16,Fellow of the Royal Society,1193,Winners,2012,1,16,general,Senior
1061,2017,3,Fellow of the Royal Society,1194,Winners,2020,0,3,general,NA
1062,1980,22,Edison Medal,1195,Winners,2002,1,22,cs,Senior
1063,1998,14,Fellow of the Royal Society,1196,Winners,2012,1,14,general,Middle
1064,2009,6,Nobel Prize in Physics,1197,Winners,2015,1,6,physics,Senior
1065,1998,21,Nobel Prize in Physiology or Medicine,1198,Winners,2019,0,21,biology,Middle
1066,1990,30,MacArthur Fellowship,1199,Winners,2020,0,30,general,Young
1067,1968,43,Nobel Prize in Physiology or Medicine,1200,Winners,2011,1,43,biology,Middle
1069,1965,48,Fellow of the Royal Society,1202,Winners,2013,1,48,general,Young
1070,2008,9,Nobel Prize in Physics,1203,Winners,2017,1,9,physics,Senior
1071,2009,0,Lasker-DeBakey Clinical Medical Research Award,1204,Winners,2009,1,0,biology,Middle
1072,2000,20,Fellow of the Royal Society,1205,Winners,2020,0,20,general,Middle
1073,2000,15,Marconi Prize,1206,Winners,2015,1,15,cs,Middle
1074,2008,10,Nobel Prize in Physics,1207,Winners,2018,0,10,physics,Senior
1075,2002,16,National Medal of Science,1208,Winners,2018,0,16,general,Senior
1076,2004,14,Fellow of the Royal Society,1209,Winners,2018,0,14,general,Middle
1077,2001,19,Fellow of the Royal Society,1210,Winners,2020,0,19,general,Young
1078,1995,23,National Medal of Science,1211,Winners,2018,0,23,general,Middle
1079,1993,20,National Medal of Science,1212,Winners,2013,1,20,general,Senior
1080,2014,5,Fellow of the Royal Society,1213,Winners,2019,0,5,general,Senior
1081,1983,37,Fellow of the Royal Society,1214,Winners,2020,0,37,general,Young
1082,2012,8,Shanti Swarup Bhatnagar Prize for Science and Technology,1215,Winners,2020,0,8,general,Young
1083,1979,37,Fellow of the Royal Society,1216,Winners,2016,1,37,general,Young
1084,1975,39,Fellow of the Royal Society,1217,Winners,2014,1,39,general,Senior
1085,1941,74,Fellow of the Royal Society,1218,Winners,2015,1,74,general,Young
1086,2013,7,Fellow of the Royal Society,59,Winners,2020,0,7,general,Senior
1087,2004,15,Fellow of the Royal Society,1219,Winners,2019,0,15,general,Middle
1088,1955,10,Willard Gibbs Award,1220,Winners,1965,1,10,chemistry,Senior
1089,2002,18,Fellow of the Royal Society,1221,Winners,2020,0,18,general,Middle
1090,2001,12,Wolf Prize in Chemistry,1222,Winners,2013,1,12,chemistry,Senior
1091,2002,0,National Medal of Science,1223,Winners,2002,1,0,general,Senior
1092,1984,27,Turing Award,1224,Winners,2011,1,27,cs,Middle
1094,1936,82,Willard Gibbs Award,1226,Winners,2018,0,82,chemistry,Middle
1095,1963,9,Lyell Medal,1227,Winners,1972,1,9,geography,Middle
1096,1999,21,Fellow of the Royal Society,1228,Winners,2020,0,21,general,NA
1097,2006,14,Nobel Prize in Chemistry,60,Winners,2020,0,14,chemistry,Middle
1098,1990,20,Nobel Prize in Physiology or Medicine,1229,Winners,2010,1,20,biology,Senior
1099,1971,29,Fellow of the Royal Society,1230,Winners,2000,1,29,general,Young
1100,2014,5,MacArthur Fellowship,1231,Winners,2019,0,5,general,Young
1101,1984,34,Fellow of the Royal Society,1232,Winners,2018,0,34,general,Middle
1102,2017,2,Fellow of the Royal Society,1233,Winners,2019,0,2,general,Senior
1103,1989,31,Fellow of the Royal Society,1234,Winners,2020,0,31,general,Young
1104,1975,33,Nobel Prize in Physics,1235,Winners,2008,1,33,physics,Middle
1105,2017,3,Fellow of the Royal Society,1236,Winners,2020,0,3,general,Senior
1106,2001,18,Fellow of the Royal Society,1237,Winners,2019,0,18,general,Young
1107,1972,30,Willard Gibbs Award,1238,Winners,2002,1,30,chemistry,Senior
1108,2000,20,MacArthur Fellowship,61,Winners,2020,0,20,general,Young
1109,2002,17,MacArthur Fellowship,62,Winners,2019,0,17,general,Young
1110,2017,3,Fellow of the Royal Society,1239,Winners,2020,0,3,general,Middle
1112,1953,25,Fellow of the Royal Society,1241,Winners,1978,1,25,general,Middle
1113,1993,27,Shanti Swarup Bhatnagar Prize for Science and Technology,1242,Winners,2020,0,27,general,Young
1114,1962,48,Fellow of the Royal Society,1243,Winners,2010,1,48,general,Middle
1115,2015,5,Nobel Prize in Chemistry,1244,Winners,2020,0,5,chemistry,Senior
1116,1968,36,Fellow of the Royal Society,1245,Winners,2004,1,36,general,Middle
1117,2017,3,Breakthrough Prize in Life Sciences,63,Winners,2020,0,3,biology,Senior
1118,2005,14,Shanti Swarup Bhatnagar Prize for Science and Technology,1246,Winners,2019,0,14,general,NA
1119,2009,10,Fellow of the Royal Society,1247,Winners,2019,0,10,general,Young
1120,1997,23,Nobel Prize in Physics,1248,Winners,2020,0,23,physics,Middle
1121,1975,34,Fellow of the Royal Society,1249,Winners,2009,1,34,general,Middle
1122,1996,23,Shanti Swarup Bhatnagar Prize for Science and Technology,1250,Winners,2019,0,23,general,Young
1123,1970,22,Nobel Prize in Physics,1251,Winners,1992,1,22,physics,Senior
1124,2017,3,Nobel Prize in Physics,1252,Winners,2020,0,3,physics,Senior
1127,1997,18,Nobel Prize in Chemistry,1255,Winners,2015,1,18,chemistry,Senior
1128,2014,6,National Medal of Science,1256,Winners,2020,0,6,general,Senior
1129,1995,25,Fellow of the Royal Society,1257,Winners,2020,0,25,general,Young
1130,1997,23,Max Planck Medal,1258,Winners,2020,0,23,physics,Senior
1131,2006,11,Shanti Swarup Bhatnagar Prize for Science and Technology,1259,Winners,2017,1,11,general,NA
1132,2014,6,Lasker-DeBakey Clinical Medical Research Award,1260,Winners,2020,0,6,biology,NA
1133,2017,3,Wolf Prize in Physics,1261,Winners,2020,0,3,physics,Middle
1134,1998,19,Lasker-DeBakey Clinical Medical Research Award,1262,Winners,2017,1,19,biology,Senior
1135,2007,8,Fellow of the Royal Society,1263,Winners,2015,1,8,general,Senior
1136,1986,32,MacArthur Fellowship,1264,Winners,2018,0,32,general,Young
1137,1980,33,Fellow of the Royal Society,1265,Winners,2013,1,33,general,NA
1138,1980,13,Fellow of the Royal Society,1266,Winners,1993,1,13,general,Middle
1139,1992,27,Fellow of the Royal Society,1267,Winners,2019,0,27,general,Middle
1140,1986,33,Fields Medal,1268,Winners,2019,0,33,mathematics,Young
1141,2012,3,Wolf Prize in Physics,1269,Winners,2015,1,3,physics,Senior
1142,1995,25,Shanti Swarup Bhatnagar Prize for Science and Technology,1270,Winners,2020,0,25,general,Young
1144,1974,17,Fellow of the Royal Society,1272,Winners,1991,1,17,general,Middle
1145,2000,19,MacArthur Fellowship,1273,Winners,2019,0,19,general,Young
1146,1995,25,Fellow of the Royal Society,1274,Winners,2020,0,25,general,Middle
1147,2017,1,Fellow of the Royal Society,1275,Winners,2018,0,1,general,Middle
1148,1989,27,Nobel Prize in Physiology or Medicine,1276,Winners,2016,1,27,biology,Middle
1149,2013,7,MacArthur Fellowship,1277,Winners,2020,0,7,general,Young
1150,2005,15,Nobel Prize in Physics,1278,Winners,2020,0,15,physics,Senior
1151,1971,48,Fellow of the Royal Society,1279,Winners,2019,0,48,general,Young
1152,2013,6,MacArthur Fellowship,64,Winners,2019,0,6,general,Middle
1153,2014,6,Nobel Prize in Physics,1280,Winners,2020,0,6,physics,Middle
1154,2000,11,Fellow of the Royal Society,1281,Winners,2011,1,11,general,Senior
1155,1945,64,Fellow of the Royal Society,1282,Winners,2009,1,64,general,Young
1156,2003,15,Nobel Prize in Chemistry,1283,Winners,2018,0,15,chemistry,Middle
1157,2010,10,National Medal of Science,1284,Winners,2020,0,10,general,Senior
1158,1944,62,Nobel Prize in Physics,1285,Winners,2006,1,62,physics,Middle
1159,2010,9,Nobel Prize in Chemistry,1286,Winners,2019,0,9,chemistry,Senior
1160,1998,21,Fellow of the Royal Society,1287,Winners,2019,0,21,general,NA
1161,2001,11,Fellow of the Royal Society,1288,Winners,2012,1,11,general,Middle
1162,1987,26,MacArthur Fellowship,1289,Winners,2013,1,26,general,Young
1163,2015,5,Fellow of the Royal Society,1290,Winners,2020,0,5,general,NA
1164,2004,16,Shanti Swarup Bhatnagar Prize for Science and Technology,1291,Winners,2020,0,16,general,Young
1165,1984,25,Shanti Swarup Bhatnagar Prize for Science and Technology,1292,Winners,2009,1,25,general,Young
1166,2015,5,Fellow of the Royal Society,1293,Winners,2020,0,5,general,Senior
1167,1965,30,Fellow of the Royal Society,1294,Winners,1995,1,30,general,Young
1168,1980,9,Fellow of the Royal Society,1295,Winners,1989,1,9,general,Middle
1169,2009,10,Wollaston Medal,1296,Winners,2019,0,10,geography,Senior
1170,2011,9,Nobel Prize in Physiology or Medicine,1297,Winners,2020,0,9,biology,Middle
1171,1976,40,Fellow of the Royal Society,1298,Winners,2016,1,40,general,Middle
1172,1974,43,Shanti Swarup Bhatnagar Prize for Science and Technology,1299,Winners,2017,1,43,general,Young
1173,1967,42,Nobel Prize in Physiology or Medicine,1300,Winners,2009,1,42,biology,Senior
1174,2015,5,Nobel Prize in Physics,1301,Winners,2020,0,5,physics,Senior
1175,2001,19,Fellow of the Royal Society,1302,Winners,2020,0,19,general,Middle
1176,2007,12,Max Planck Medal,1303,Winners,2019,0,12,physics,Senior
1177,2001,18,Shanti Swarup Bhatnagar Prize for Science and Technology,1304,Winners,2019,0,18,general,Young
1178,2011,9,National Medal of Science,1305,Winners,2020,0,9,general,Senior
1179,1979,37,Shanti Swarup Bhatnagar Prize for Science and Technology,1306,Winners,2016,1,37,general,Young
1180,1991,28,Fellow of the Royal Society,1307,Winners,2019,0,28,general,Middle
1181,1995,4,Fellow of the Royal Society,1308,Winners,1999,1,4,general,Middle
1182,1974,43,Shanti Swarup Bhatnagar Prize for Science and Technology,1309,Winners,2017,1,43,general,Young
1183,2001,19,National Medal of Science,1310,Winners,2020,0,19,general,Senior
1184,2011,7,National Medal of Science,1311,Winners,2018,0,7,general,Senior
1185,2007,13,Fellow of the Royal Society,1312,Winners,2020,0,13,general,Middle
1186,2010,10,MacArthur Fellowship,1313,Winners,2020,0,10,general,Young
1187,1998,7,Fellow of the Royal Society,1314,Winners,2005,1,7,general,Senior
1188,1979,28,Turing Award,1315,Winners,2007,1,28,cs,Middle
1189,1989,30,Shanti Swarup Bhatnagar Prize for Science and Technology,1316,Winners,2019,0,30,general,Young
1190,2001,13,Shanti Swarup Bhatnagar Prize for Science and Technology,1317,Winners,2014,1,13,general,Young
1191,2010,9,Wolf Prize in Physics,1318,Winners,2019,0,9,physics,Senior
1192,2015,5,Nobel Prize in Physiology or Medicine,1319,Winners,2020,0,5,biology,Senior
1193,1949,7,Hughes Medal,1320,Winners,1956,1,7,physics,Middle
1194,1963,39,Lasker-DeBakey Clinical Medical Research Award,1321,Winners,2002,1,39,biology,Senior
1195,1987,32,MacArthur Fellowship,1322,Winners,2019,0,32,general,Young
1196,1997,17,National Medal of Science,1323,Winners,2014,1,17,general,Senior
1197,1951,1,Hughes Medal,1324,Winners,1952,1,1,physics,Middle
1198,1983,15,MacArthur Fellowship,1325,Winners,1998,1,15,general,Middle
1200,1957,17,Nobel Prize in Physiology or Medicine,1327,Winners,1974,1,17,biology,Middle
1201,2011,9,Fellow of the Royal Society,65,Winners,2020,0,9,general,Middle
1202,1982,38,Wolf Prize in Medicine,1328,Winners,2020,0,38,biology,Middle
1203,1994,21,Lasker-DeBakey Clinical Medical Research Award,1329,Winners,2015,1,21,biology,Senior
1204,1982,37,MacArthur Fellowship,1330,Winners,2019,0,37,general,Young
1205,1990,16,Lyell Medal,1331,Winners,2006,1,16,geography,Middle
1206,1968,46,National Medal of Science,1332,Winners,2014,1,46,general,Senior
1207,2001,1,Nobel Prize in Chemistry,1333,Winners,2002,1,1,chemistry,Senior
1208,1964,39,Nobel Prize in Physics,1334,Winners,2003,1,39,physics,Middle
1209,2006,14,Wolf Prize in Physics,1335,Winners,2020,0,14,physics,Senior
1210,1974,40,Lasker-DeBakey Clinical Medical Research Award,1336,Winners,2014,1,40,biology,Senior
1211,2016,3,Breakthrough Prize in Life Sciences,66,Winners,2019,0,3,biology,Senior
1213,2008,10,Nobel Prize in Chemistry,1338,Winners,2018,0,10,chemistry,Senior
1214,1968,45,Fellow of the Royal Society,1339,Winners,2013,1,45,general,Young
1215,1979,38,Wolf Prize in Medicine,1340,Winners,2017,1,38,biology,Middle
1216,2004,2,Nobel Prize in Chemistry,1341,Winners,2006,1,2,chemistry,Senior
1217,1956,59,Fellow of the Royal Society,1342,Winners,2015,1,59,general,Young
1218,1993,21,Shanti Swarup Bhatnagar Prize for Science and Technology,1343,Winners,2014,1,21,general,Young
1219,1994,18,Nobel Prize in Physiology or Medicine,1344,Winners,2012,1,18,biology,Middle
1220,1981,31,Fellow of the Royal Society,1345,Winners,2012,1,31,general,Middle
1221,1952,55,Nobel Prize in Physics,1346,Winners,2007,1,55,physics,Middle
1222,1988,32,Shanti Swarup Bhatnagar Prize for Science and Technology,1347,Winners,2020,0,32,general,Young
1223,1975,33,Shanti Swarup Bhatnagar Prize for Science and Technology,1348,Winners,2008,1,33,general,Young
1224,2004,1,Nobel Prize in Physics,1349,Winners,2005,1,1,physics,Middle
1225,1990,29,Shanti Swarup Bhatnagar Prize for Science and Technology,67,Winners,2019,0,29,general,Young
1226,1963,2,Nobel Prize in Physics,1350,Winners,1965,1,2,physics,Middle
1227,1982,35,Shanti Swarup Bhatnagar Prize for Science and Technology,1351,Winners,2017,1,35,general,Young
1228,1983,26,Wolf Prize in Chemistry,1352,Winners,2009,1,26,chemistry,Middle
1229,1914,80,Nobel Prize in Physics,1353,Winners,1994,1,80,physics,Young
1230,1979,40,Shanti Swarup Bhatnagar Prize for Science and Technology,1354,Winners,2019,0,40,general,Young
1231,2002,17,Nobel Prize in Chemistry,1355,Winners,2019,0,17,chemistry,Young
1232,2015,5,Nobel Prize in Physics,1356,Winners,2020,0,5,physics,Middle
1233,1985,26,Shanti Swarup Bhatnagar Prize for Science and Technology,1357,Winners,2011,1,26,general,Young
1234,2006,14,Fellow of the Royal Society,1358,Winners,2020,0,14,general,Senior
1235,1975,35,Shanti Swarup Bhatnagar Prize for Science and Technology,1359,Winners,2010,1,35,general,Young
1237,1978,34,Nobel Prize in Physics,1361,Winners,2012,1,34,physics,Young
1238,2003,17,MacArthur Fellowship,1362,Winners,2020,0,17,general,Young
1239,1990,19,National Medal of Science,1363,Winners,2009,1,19,general,Senior
1240,1981,39,MacArthur Fellowship,1364,Winners,2020,0,39,general,Young
1241,1995,24,Wolf Prize in Chemistry,1365,Winners,2019,0,24,chemistry,Middle
1242,2008,3,Max Planck Medal,1366,Winners,2011,1,3,physics,Senior
1243,1987,33,MacArthur Fellowship,1367,Winners,2020,0,33,general,Young
1244,1987,21,Fellow of the Royal Society,1368,Winners,2008,1,21,general,Middle
1246,1968,46,Fellow of the Royal Society,1370,Winners,2014,1,46,general,Young
1247,1983,8,National Medal of Science,1371,Winners,1991,1,8,general,Senior
1248,1991,29,National Medal of Science,1372,Winners,2020,0,29,general,Middle
1249,1990,29,Shanti Swarup Bhatnagar Prize for Science and Technology,1373,Winners,2019,0,29,general,Young
1250,2017,3,Breakthrough Prize in Life Sciences,68,Winners,2020,0,3,biology,Senior
1252,1980,36,Fellow of the Royal Society,1375,Winners,2016,1,36,general,Young
1253,1973,37,National Medal of Science,1376,Winners,2010,1,37,general,Senior
1254,1952,48,Fellow of the Royal Society,1377,Winners,2000,1,48,general,Middle
1255,2001,19,Nobel Prize in Physics,69,Winners,2020,0,19,physics,Young
1257,1967,36,Fellow of the Royal Society,1379,Winners,2003,1,36,general,Young
1258,1990,10,Nobel Prize in Physics,1380,Winners,2000,1,10,physics,Senior
1259,1946,10,Nobel Prize in Chemistry,1381,Winners,1956,1,10,chemistry,Middle
1260,1974,41,Fellow of the Royal Society,1382,Winners,2015,1,41,general,Middle
1261,1984,36,MacArthur Fellowship,1383,Winners,2020,0,36,general,Young
1262,1982,35,MacArthur Fellowship,1384,Winners,2017,1,35,general,Young
1263,2001,17,Fellow of the Royal Society,1385,Winners,2018,0,17,general,Middle
1264,1979,34,National Medal of Science,1386,Winners,2013,1,34,general,Senior
1265,2018,1,Fellow of the Royal Society,1387,Winners,2019,0,1,general,Middle
1266,1997,8,Edison Medal,1388,Winners,2005,1,8,cs,Senior
1267,1964,52,Fellow of the Royal Society,1389,Winners,2016,1,52,general,Young
1268,1999,6,Fellow of the Royal Society,1390,Winners,2005,1,6,general,Young
1269,1978,41,Wolf Prize in Medicine,1391,Winners,2019,0,41,biology,Middle
1270,1986,28,Fellow of the Royal Society,1392,Winners,2014,1,28,general,Young
1271,1967,49,Shanti Swarup Bhatnagar Prize for Science and Technology,1393,Winners,2016,1,49,general,Young
1272,2009,6,Shanti Swarup Bhatnagar Prize for Science and Technology,1394,Winners,2015,1,6,general,Young
1273,1988,29,Fellow of the Royal Society,1395,Winners,2017,1,29,general,Young
1274,1975,45,Nobel Prize in Physiology or Medicine,1396,Winners,2020,0,45,biology,Young
1275,1994,8,National Medal of Science,1397,Winners,2002,1,8,general,Senior
1276,1947,36,Fellow of the Royal Society,1398,Winners,1983,1,36,general,Middle
1277,1958,50,Fellow of the Royal Society,1399,Winners,2008,1,50,general,Young
1278,1991,17,National Medal of Science,1400,Winners,2008,1,17,general,Senior
1279,1981,37,Fellow of the Royal Society,1401,Winners,2018,0,37,general,Young
1280,1984,18,MacArthur Fellowship,1402,Winners,2002,1,18,general,Young
1281,1983,25,National Medal of Science,1403,Winners,2008,1,25,general,Senior
1282,1988,9,MacArthur Fellowship,1404,Winners,1997,1,9,general,Middle
1283,2005,15,Fellow of the Royal Society,1405,Winners,2020,0,15,general,Middle
1284,1985,28,Fellow of the Royal Society,1406,Winners,2013,1,28,general,Young
1285,2011,9,Fellow of the Royal Society,1407,Winners,2020,0,9,general,Senior
1286,1986,28,Wolf Prize in Medicine,1408,Winners,2014,1,28,biology,Senior
1287,1989,16,Nobel Prize in Physics,70,Winners,2005,1,16,physics,Senior
1288,1976,42,Turing Award,1409,Winners,2018,0,42,cs,Young
1289,2017,3,Fellow of the Royal Society,71,Winners,2020,0,3,general,Middle
1290,2013,7,Fellow of the Royal Society,1410,Winners,2020,0,7,general,Middle
1291,1978,41,Fellow of the Royal Society,1411,Winners,2019,0,41,general,Young
1292,1990,22,Nobel Prize in Physics,1412,Winners,2012,1,22,physics,Middle
1293,1978,19,Fellow of the Royal Society,1413,Winners,1997,1,19,general,Senior
1294,1989,26,Fellow of the Royal Society,1414,Winners,2015,1,26,general,Senior
1295,2008,11,Hughes Medal,1415,Winners,2019,0,11,physics,Middle
1296,1965,47,National Medal of Science,1416,Winners,2012,1,47,general,Young
1297,1996,22,Fellow of the Royal Society,1417,Winners,2018,0,22,general,Young
1299,1960,51,Nobel Prize in Physics,1419,Winners,2011,1,51,physics,Young
1300,2006,13,National Medal of Science,1420,Winners,2019,0,13,general,Senior
1301,2010,9,MacArthur Fellowship,1421,Winners,2019,0,9,general,Young
1302,1982,27,Willard Gibbs Award,1422,Winners,2009,1,27,chemistry,Senior
1303,1967,16,Fellow of the Royal Society,1423,Winners,1983,1,16,general,Young
1304,1964,17,Nobel Prize in Physiology or Medicine,1424,Winners,1981,1,17,biology,Middle
1305,1990,26,Nobel Prize in Physics,1425,Winners,2016,1,26,physics,Senior
1306,2016,4,Wolf Prize in Chemistry,1426,Winners,2020,0,4,chemistry,Middle
1307,2002,17,Fellow of the Royal Society,1427,Winners,2019,0,17,general,Middle
1308,1983,33,Shanti Swarup Bhatnagar Prize for Science and Technology,1428,Winners,2016,1,33,general,Young
1309,1999,10,MacArthur Fellowship,1429,Winners,2009,1,10,general,Young
1310,1954,44,Nobel Prize in Physiology or Medicine,1430,Winners,1998,1,44,biology,Young
1311,2006,12,Fellow of the Royal Society,1431,Winners,2018,0,12,general,NA
1312,2009,10,Fellow of the Royal Society,1432,Winners,2019,0,10,general,Middle
1313,1995,25,Fellow of the Royal Society,1433,Winners,2020,0,25,general,Middle
1315,1950,3,Fellow of the Royal Society,1435,Winners,1953,1,3,general,Young
1316,1999,1,Nobel Prize in Physics,1436,Winners,2000,1,1,physics,Senior
1317,2009,10,MacArthur Fellowship,1437,Winners,2019,0,10,general,Young
1318,1983,17,Fellow of the Royal Society,1438,Winners,2000,1,17,general,Middle
1320,1991,15,National Medal of Science,1440,Winners,2006,1,15,general,Senior
1321,1966,20,Turing Award,1441,Winners,1986,1,20,cs,Young
1322,2017,3,Nobel Prize in Physiology or Medicine,1442,Winners,2020,0,3,biology,Senior
1323,1993,23,MacArthur Fellowship,1443,Winners,2016,1,23,general,Young
1324,2018,2,Breakthrough Prize in Life Sciences,72,Winners,2020,0,2,biology,Senior
1325,1963,1,Bigsby Medal,1444,Winners,1964,1,1,geography,Young
1326,1988,1,Nobel Prize in Physics,1445,Winners,1989,1,1,physics,Middle
1327,2007,13,Fellow of the Royal Society,1446,Winners,2020,0,13,general,Middle
1328,1999,21,MacArthur Fellowship,73,Winners,2020,0,21,general,Young
1329,1980,21,Fellow of the Royal Society,1447,Winners,2001,1,21,general,Middle
1330,1986,24,Fellow of the Royal Society,1448,Winners,2010,1,24,general,Middle
1331,2009,11,Shanti Swarup Bhatnagar Prize for Science and Technology,1449,Winners,2020,0,11,general,NA
1332,1965,10,Shanti Swarup Bhatnagar Prize for Science and Technology,1450,Winners,1975,1,10,general,Young
1333,1972,36,Fellow of the Royal Society,1451,Winners,2008,1,36,general,Young
1335,1997,8,National Medal of Science,1453,Winners,2005,1,8,general,Senior
1340,1962,46,Fields Medal,74,Winners,2008,1,46,mathematics,Young
1341,1979,37,Nobel Prize in Physics,1458,Winners,2016,1,37,physics,Middle
1342,1941,70,Fellow of the Royal Society,1459,Winners,2011,1,70,general,Young
1343,1986,24,Lasker-DeBakey Clinical Medical Research Award,1460,Winners,2010,1,24,biology,Middle
1345,2009,10,MacArthur Fellowship,75,Winners,2019,0,10,general,Middle
1346,1994,23,Nobel Prize in Chemistry,1462,Winners,2017,1,23,chemistry,Senior
1347,1994,5,National Medal of Science,1463,Winners,1999,1,5,general,Senior
1348,1971,32,Willard Gibbs Award,1464,Winners,2003,1,32,chemistry,Middle
1349,1974,25,Fellow of the Royal Society,1465,Winners,1999,1,25,general,Middle
1350,1980,39,Shanti Swarup Bhatnagar Prize for Science and Technology,1466,Winners,2019,0,39,general,Young
1351,2001,15,Fellow of the Royal Society,76,Winners,2016,1,15,general,Middle
1352,2003,17,National Medal of Science,77,Winners,2020,0,17,general,Senior
1353,2001,19,MacArthur Fellowship,78,Winners,2020,0,19,general,NA
1354,2006,13,Wolf Prize in Chemistry,79,Winners,2019,0,13,chemistry,Senior
1355,1989,31,Nobel Prize in Chemistry,80,Winners,2020,0,31,chemistry,Young
1356,2007,13,MacArthur Fellowship,81,Winners,2020,0,13,general,Middle
1357,1955,54,Nobel Prize in Chemistry,82,Winners,2009,1,54,chemistry,Middle
1358,1998,21,MacArthur Fellowship,83,Winners,2019,0,21,general,Young
1359,1993,26,MacArthur Fellowship,84,Winners,2019,0,26,general,Middle
1360,2014,6,Breakthrough Prize in Life Sciences,85,Winners,2020,0,6,biology,Senior
1361,2013,7,Nobel Prize in Physiology or Medicine,86,Winners,2020,0,7,biology,Middle
1362,2014,6,Nobel Prize in Chemistry,87,Winners,2020,0,6,chemistry,Middle
1363,1998,22,Fellow of the Royal Society,88,Winners,2020,0,22,general,Middle
1364,1992,25,Fellow of the Royal Society,89,Winners,2017,1,25,general,Senior
1365,1993,26,Wolf Prize in Chemistry,90,Winners,2019,0,26,chemistry,Middle
1366,1987,32,Wolf Prize in Medicine,6,Winners,2019,0,32,biology,Middle
1367,2015,3,Marconi Prize,91,Winners,2018,0,3,cs,Senior
1368,1987,32,Fellow of the Royal Society,92,Winners,2019,0,32,general,Young
1369,1990,18,Wolf Prize in Physics,93,Winners,2008,1,18,physics,Middle
1370,2014,6,Fellow of the Royal Society,94,Winners,2020,0,6,general,Middle
1371,2005,15,Fellow of the Royal Society,95,Winners,2020,0,15,general,Middle
1372,2016,4,Fellow of the Royal Society,96,Winners,2020,0,4,general,Middle
1373,2012,8,National Medal of Science,97,Winners,2020,0,8,general,Senior
1374,1983,28,Fellow of the Royal Society,98,Winners,2011,1,28,general,Young
1375,1986,28,Fellow of the Royal Society,99,Winners,2014,1,28,general,Young
1376,1996,22,Nobel Prize in Physiology or Medicine,100,Winners,2018,0,22,biology,Middle
1377,1999,21,Fellow of the Royal Society,101,Winners,2020,0,21,general,Middle
1378,2014,5,Fields Medal,102,Winners,2019,0,5,mathematics,Young
1379,1955,37,Lasker-DeBakey Clinical Medical Research Award,103,Winners,1992,1,37,biology,Young
1380,1997,22,Nobel Prize in Physics,7,Winners,2019,0,22,physics,Senior
1381,1999,21,MacArthur Fellowship,104,Winners,2020,0,21,general,Young
1382,2008,12,Shanti Swarup Bhatnagar Prize for Science and Technology,105,Winners,2020,0,12,general,Young
1383,2003,17,MacArthur Fellowship,106,Winners,2020,0,17,general,Young
1384,2008,12,Wolf Prize in Chemistry,107,Winners,2020,0,12,chemistry,Middle
1385,2001,18,Shanti Swarup Bhatnagar Prize for Science and Technology,108,Winners,2019,0,18,general,Young
1386,1983,37,National Medal of Science,109,Winners,2020,0,37,general,Young
1387,2003,17,MacArthur Fellowship,8,Winners,2020,0,17,general,Young
1388,1993,24,Fellow of the Royal Society,110,Winners,2017,1,24,general,Young
1389,2006,14,Fields Medal,111,Winners,2020,0,14,mathematics,Young
1390,1989,13,National Medal of Science,112,Winners,2002,1,13,general,Senior
1391,2005,14,Shanti Swarup Bhatnagar Prize for Science and Technology,113,Winners,2019,0,14,general,Young
1392,2008,12,MacArthur Fellowship,9,Winners,2020,0,12,general,Young
1393,2007,13,Fellow of the Royal Society,114,Winners,2020,0,13,general,Middle
1394,1986,34,Shanti Swarup Bhatnagar Prize for Science and Technology,115,Winners,2020,0,34,general,Young
1395,2010,9,Shanti Swarup Bhatnagar Prize for Science and Technology,116,Winners,2019,0,9,general,Young
1396,1983,37,MacArthur Fellowship,117,Winners,2020,0,37,general,Young
1397,1997,23,Fellow of the Royal Society,118,Winners,2020,0,23,general,Middle
1398,2002,17,Nobel Prize in Physiology or Medicine,119,Winners,2019,0,17,biology,Middle
1399,2009,11,Shanti Swarup Bhatnagar Prize for Science and Technology,10,Winners,2020,0,11,general,NA
1400,2006,14,Fellow of the Royal Society,11,Winners,2020,0,14,general,Middle
1401,1983,19,MacArthur Fellowship,120,Winners,2002,1,19,general,Young
1402,2015,5,Fellow of the Royal Society,12,Winners,2020,0,5,general,Senior
1403,2018,2,Breakthrough Prize in Mathematics,13,Winners,2020,0,2,mathematics,Middle
1404,1995,8,Fellow of the Royal Society,121,Winners,2003,1,8,general,Middle
1405,2010,10,MacArthur Fellowship,122,Winners,2020,0,10,general,Young
1406,2015,5,Nobel Prize in Chemistry,123,Winners,2020,0,5,chemistry,Senior
1407,2012,8,Wolf Prize in Mathematics,124,Winners,2020,0,8,mathematics,Senior
1408,2005,11,Turing Award,125,Winners,2016,1,11,cs,Senior
1409,2005,14,Wolf Prize in Medicine,126,Winners,2019,0,14,biology,Senior
1410,1954,52,Fellow of the Royal Society,14,Winners,2006,1,52,general,Middle
1411,1980,38,Fellow of the Royal Society,127,Winners,2018,0,38,general,Middle
1412,2001,19,Fellow of the Royal Society,128,Winners,2020,0,19,general,Middle
1413,2015,4,SASTRA Ramanujan Prize,15,Winners,2019,0,4,mathematics,Young
1414,1995,24,MacArthur Fellowship,129,Winners,2019,0,24,general,Young
1415,2005,14,National Medal of Science,130,Winners,2019,0,14,general,Senior
1416,2010,10,Willard Gibbs Award,131,Winners,2020,0,10,chemistry,Senior
1417,1989,19,National Medal of Science,132,Winners,2008,1,19,general,Senior
1418,1999,13,Fellow of the Royal Society,133,Winners,2012,1,13,general,Senior
1419,1992,28,MacArthur Fellowship,134,Winners,2020,0,28,general,Middle
1420,1983,34,Fellow of the Royal Society,135,Winners,2017,1,34,general,Young
1421,2004,16,MacArthur Fellowship,136,Winners,2020,0,16,general,Young
1422,2016,4,Fellow of the Royal Society,137,Winners,2020,0,4,general,NA
1423,1994,25,Fields Medal,138,Winners,2019,0,25,mathematics,Young
1424,2007,13,Hughes Medal,139,Winners,2020,0,13,physics,Middle
1425,2005,14,Nobel Prize in Chemistry,140,Winners,2019,0,14,chemistry,Middle
1426,2002,15,Fellow of the Royal Society,141,Winners,2017,1,15,general,Senior
1427,2006,14,Nobel Prize in Physiology or Medicine,142,Winners,2020,0,14,biology,Middle
1428,1993,22,Fellow of the Royal Society,143,Winners,2015,1,22,general,Middle
1429,1966,47,Fellow of the Royal Society,144,Winners,2013,1,47,general,Young
1430,1990,29,MacArthur Fellowship,145,Winners,2019,0,29,general,Young
1431,2005,14,MacArthur Fellowship,146,Winners,2019,0,14,general,Young
1432,2007,13,Fellow of the Royal Society,147,Winners,2020,0,13,general,Middle
1433,1981,35,MacArthur Fellowship,148,Winners,2016,1,35,general,Middle
1434,2008,12,Fellow of the Royal Society,149,Winners,2020,0,12,general,NA
1435,1991,28,Shanti Swarup Bhatnagar Prize for Science and Technology,150,Winners,2019,0,28,general,Young
1436,1987,32,MacArthur Fellowship,151,Winners,2019,0,32,general,Young
1437,1963,57,Lasker-DeBakey Clinical Medical Research Award,152,Winners,2020,0,57,biology,Middle
1438,2000,19,MacArthur Fellowship,153,Winners,2019,0,19,general,Middle
1439,1985,18,Willard Gibbs Award,154,Winners,2003,1,18,chemistry,Senior
1440,2002,17,Wolf Prize in Medicine,1,Winners,2019,0,17,biology,Senior
1441,1989,31,Nobel Prize in Physiology or Medicine,155,Winners,2020,0,31,biology,Middle
1442,1990,28,MacArthur Fellowship,156,Winners,2018,0,28,general,Middle
1443,1995,25,Nobel Prize in Physiology or Medicine,157,Winners,2020,0,25,biology,Middle
1444,1990,25,Fellow of the Royal Society,158,Winners,2015,1,25,general,Middle
1445,2017,1,Nobel Prize in Chemistry,159,Winners,2018,0,1,chemistry,Senior
1446,1986,26,Nobel Prize in Physiology or Medicine,160,Winners,2012,1,26,biology,Senior
1447,1991,28,Nobel Prize in Physiology or Medicine,161,Winners,2019,0,28,biology,Middle
1448,1974,23,National Medal of Science,162,Winners,1997,1,23,general,Senior
1449,2008,12,Fellow of the Royal Society,163,Winners,2020,0,12,general,NA
1450,2001,19,MacArthur Fellowship,164,Winners,2020,0,19,general,Young
1451,1992,20,MacArthur Fellowship,165,Winners,2012,1,20,general,Senior
1452,1984,35,MacArthur Fellowship,166,Winners,2019,0,35,general,Middle
1453,2012,8,Nobel Prize in Chemistry,167,Winners,2020,0,8,chemistry,Middle
1454,2009,11,Lasker-DeBakey Clinical Medical Research Award,168,Winners,2020,0,11,biology,Middle
1455,1975,40,Fellow of the Royal Society,169,Winners,2015,1,40,general,Middle
1456,2008,11,Wolf Prize in Medicine,16,Winners,2019,0,11,biology,Senior
1457,1984,32,MacArthur Fellowship,17,Winners,2016,1,32,general,Middle
1458,2004,16,National Medal of Science,18,Winners,2020,0,16,general,Senior
1459,2011,9,Fellow of the Royal Society,19,Winners,2020,0,9,general,NA
1460,1984,36,Fellow of the Royal Society,20,Winners,2020,0,36,general,Young
1461,1944,20,Nobel Prize in Physiology or Medicine,2,Winners,1964,1,20,biology,Senior
1462,2001,19,MacArthur Fellowship,170,Winners,2020,0,19,general,NA
1464,2001,17,Nobel Prize in Chemistry,21,Winners,2018,0,17,chemistry,Senior
1465,1998,22,National Medal of Science,22,Winners,2020,0,22,general,Senior
1466,2016,4,Wolf Prize in Physics,23,Winners,2020,0,4,physics,Senior
1467,2002,8,Lasker-DeBakey Clinical Medical Research Award,413,Contenders,2010,1,8,biology,Senior
1468,2001,19,MacArthur Fellowship,1119,Contenders,2020,0,19,general,Young
1469,2007,12,Fellow of the Royal Society,927,Contenders,2019,0,12,general,Middle
1470,1999,21,Fellow of the Royal Society,1049,Contenders,2020,0,21,general,Middle
1471,2017,3,Breakthrough Prize in Life Sciences,37,Contenders,2020,0,3,biology,Senior
1472,1988,32,MacArthur Fellowship,1404,Contenders,2020,0,32,general,Middle
1473,2015,5,Fellow of the Royal Society,455,Contenders,2020,0,5,general,NA
1474,2006,14,Nobel Prize in Physiology or Medicine,142,Contenders,2020,0,14,biology,Middle
1475,2006,14,Fellow of the Royal Society,599,Contenders,2020,0,14,general,Young
1476,1986,21,MacArthur Fellowship,357,Contenders,2007,1,21,general,Young
1477,2015,5,Breakthrough Prize in Life Sciences,34,Contenders,2020,0,5,biology,Middle
1478,2014,5,Nobel Prize in Physiology or Medicine,905,Contenders,2019,0,5,biology,Senior
1479,1994,23,Nobel Prize in Physiology or Medicine,1344,Contenders,2017,1,23,biology,Middle
1480,1999,20,Fellow of the Royal Society,254,Contenders,2019,0,20,general,Young
1481,2016,3,Fellow of the Royal Society,549,Contenders,2019,0,3,general,Senior
1482,1966,2,Lasker-DeBakey Clinical Medical Research Award,982,Contenders,1968,1,2,biology,Senior
1484,2013,7,Fellow of the Royal Society,645,Contenders,2020,0,7,general,Middle
1485,2009,11,Lasker-DeBakey Clinical Medical Research Award,168,Contenders,2020,0,11,biology,Middle
1486,1984,28,Wolf Prize in Medicine,469,Contenders,2012,1,28,biology,Middle
1487,1998,20,MacArthur Fellowship,304,Contenders,2018,0,20,general,NA
1488,2004,16,Fellow of the Royal Society,1011,Contenders,2020,0,16,general,Middle
1489,2013,7,Fellow of the Royal Society,645,Contenders,2020,0,7,general,Middle
1490,2003,15,Lasker-DeBakey Clinical Medical Research Award,604,Contenders,2018,0,15,biology,Senior
1491,1971,24,Shanti Swarup Bhatnagar Prize for Science and Technology,476,Contenders,1995,1,24,general,Young
1492,2006,14,Shanti Swarup Bhatnagar Prize for Science and Technology,470,Contenders,2020,0,14,general,Young
1493,2005,15,Nobel Prize in Physics,1278,Contenders,2020,0,15,physics,Senior
1494,1983,14,Fellow of the Royal Society,1214,Contenders,1997,1,14,general,Young
1495,1958,3,Fellow of the Royal Society,1399,Contenders,1961,1,3,general,Young
1496,1992,25,Fellow of the Royal Society,1070,Contenders,2017,1,25,general,Senior
1497,2006,10,Shanti Swarup Bhatnagar Prize for Science and Technology,554,Contenders,2016,1,10,general,Young
1498,2008,12,Wolf Prize in Chemistry,107,Contenders,2020,0,12,chemistry,Middle
1499,1992,28,MacArthur Fellowship,929,Contenders,2020,0,28,general,Young
1500,2008,12,Fellow of the Royal Society,560,Contenders,2020,0,12,general,Middle
1501,2004,15,Shanti Swarup Bhatnagar Prize for Science and Technology,956,Contenders,2019,0,15,general,Young
1502,2006,14,Fellow of the Royal Society,1060,Contenders,2020,0,14,general,Senior
1503,2004,16,Fellow of the Royal Society,1110,Contenders,2020,0,16,general,Senior
1504,1992,8,Shanti Swarup Bhatnagar Prize for Science and Technology,1050,Contenders,2000,1,8,general,Young
1505,2000,20,Fellow of the Royal Society,726,Contenders,2020,0,20,general,Young
1506,1931,37,Nobel Prize in Physiology or Medicine,210,Contenders,1968,1,37,biology,Middle
1507,2002,16,MacArthur Fellowship,574,Contenders,2018,0,16,general,Young
1508,2008,12,Shanti Swarup Bhatnagar Prize for Science and Technology,567,Contenders,2020,0,12,general,Young
1509,2007,13,Fellow of the Royal Society,712,Contenders,2020,0,13,general,Senior
1510,1996,24,Fellow of the Royal Society,1193,Contenders,2020,0,24,general,Senior
1511,2016,4,Fellow of the Royal Society,1076,Contenders,2020,0,4,general,Senior
1512,2003,16,MacArthur Fellowship,8,Contenders,2019,0,16,general,Young
1513,1985,35,Fellow of the Royal Society,849,Contenders,2020,0,35,general,Middle
1514,2009,11,MacArthur Fellowship,1108,Contenders,2020,0,11,general,Young
1515,1988,15,MacArthur Fellowship,1404,Contenders,2003,1,15,general,Middle
1517,1999,20,Fellow of the Royal Society,101,Contenders,2019,0,20,general,Middle
1518,2001,6,Wolf Prize in Medicine,793,Contenders,2007,1,6,biology,Middle
1519,2006,14,Fields Medal,948,Contenders,2020,0,14,mathematics,Young
1520,1982,32,Fellow of the Royal Society,703,Contenders,2014,1,32,general,Middle
1521,2007,10,Fellow of the Royal Society,550,Contenders,2017,1,10,general,NA
1522,1993,27,Fellow of the Royal Society,833,Contenders,2020,0,27,general,Middle
1523,1977,41,Fellow of the Royal Society,478,Contenders,2018,0,41,general,Young
1524,1989,26,Nobel Prize in Chemistry,80,Contenders,2015,1,26,chemistry,Young
1525,1954,26,Nobel Prize in Physiology or Medicine,1430,Contenders,1980,1,26,biology,Young
1526,2017,3,Fellow of the Royal Society,461,Contenders,2020,0,3,general,Senior
1527,2002,18,Fellow of the Royal Society,1152,Contenders,2020,0,18,general,Middle
1528,2014,5,MacArthur Fellowship,1231,Contenders,2019,0,5,general,Young
1529,1992,6,Shanti Swarup Bhatnagar Prize for Science and Technology,177,Contenders,1998,1,6,general,Young
1530,2015,5,Breakthrough Prize in Life Sciences,179,Contenders,2020,0,5,biology,Young
1531,2004,15,Fellow of the Royal Society,1219,Contenders,2019,0,15,general,Middle
1532,2016,4,Fellow of the Royal Society,415,Contenders,2020,0,4,general,Senior
1533,1970,18,Fellow of the Royal Society,995,Contenders,1988,1,18,general,Senior
1535,2017,3,Fellow of the Royal Society,576,Contenders,2020,0,3,general,NA
1536,2017,3,Fellow of the Royal Society,537,Contenders,2020,0,3,general,Senior
1537,2016,4,Fellow of the Royal Society,268,Contenders,2020,0,4,general,Middle
1538,2008,10,Nobel Prize in Physiology or Medicine,24,Contenders,2018,0,10,biology,Senior
1539,1982,21,MacArthur Fellowship,1384,Contenders,2003,1,21,general,Young
1540,2009,10,Shanti Swarup Bhatnagar Prize for Science and Technology,175,Contenders,2019,0,10,general,Young
1541,1973,8,National Medal of Science,1376,Contenders,1981,1,8,general,Senior
1542,2008,12,Fellow of the Royal Society,219,Contenders,2020,0,12,general,Young
1543,2017,3,Breakthrough Prize in Life Sciences,68,Contenders,2020,0,3,biology,Senior
1544,1991,29,Fellow of the Royal Society,488,Contenders,2020,0,29,general,Young
1545,1965,10,Nobel Prize in Physiology or Medicine,303,Contenders,1975,1,10,biology,Middle
1546,2004,16,Shanti Swarup Bhatnagar Prize for Science and Technology,1291,Contenders,2020,0,16,general,Young
1547,2014,6,Fields Medal,605,Contenders,2020,0,6,mathematics,Young
1548,2009,11,Fellow of the Royal Society,398,Contenders,2020,0,11,general,Middle
1549,1998,18,Fellow of the Royal Society,1314,Contenders,2016,1,18,general,Senior
1550,2003,9,National Medal of Science,203,Contenders,2012,1,9,general,Senior
1551,1985,31,Fellow of the Royal Society,1087,Contenders,2016,1,31,general,Middle
1552,1992,17,MacArthur Fellowship,1092,Contenders,2009,1,17,general,Middle
1553,2005,15,MacArthur Fellowship,671,Contenders,2020,0,15,general,Young
1554,1993,17,Willard Gibbs Award,189,Contenders,2010,1,17,chemistry,Middle
1555,1997,22,Fellow of the Royal Society,729,Contenders,2019,0,22,general,Middle
1556,2008,12,Nobel Prize in Physiology or Medicine,397,Contenders,2020,0,12,biology,Senior
1557,2015,5,Fellow of the Royal Society,1290,Contenders,2020,0,5,general,NA
1558,2007,12,Shanti Swarup Bhatnagar Prize for Science and Technology,1032,Contenders,2019,0,12,general,NA
1560,1997,23,Nobel Prize in Physics,903,Contenders,2020,0,23,physics,Middle
1561,1999,21,MacArthur Fellowship,73,Contenders,2020,0,21,general,Young
1562,2001,19,MacArthur Fellowship,78,Contenders,2020,0,19,general,NA
1563,2017,3,Breakthrough Prize in Life Sciences,63,Contenders,2020,0,3,biology,Senior
1564,1995,1,Fellow of the Royal Society,1176,Contenders,1996,1,1,general,Senior
1565,2018,2,Fellow of the Royal Society,607,Contenders,2020,0,2,general,Senior
1566,2016,4,Wolf Prize in Medicine,978,Contenders,2020,0,4,biology,Senior
1567,1983,36,Fellow of the Royal Society,370,Contenders,2019,0,36,general,Young
1568,1989,30,Fellow of the Royal Society,399,Contenders,2019,0,30,general,Young
1569,2012,8,Shanti Swarup Bhatnagar Prize for Science and Technology,1013,Contenders,2020,0,8,general,Senior
1570,2001,9,Shanti Swarup Bhatnagar Prize for Science and Technology,1304,Contenders,2010,1,9,general,Young
1571,1973,5,National Medal of Science,1073,Contenders,1978,1,5,general,Senior
1572,1983,21,MacArthur Fellowship,39,Contenders,2004,1,21,general,Young
1573,2005,14,Shanti Swarup Bhatnagar Prize for Science and Technology,1246,Contenders,2019,0,14,general,NA
1574,2015,5,SASTRA Ramanujan Prize,15,Contenders,2020,0,5,mathematics,Young
1575,2013,7,Fellow of the Royal Society,645,Contenders,2020,0,7,general,Middle
1576,1990,30,Fellow of the Royal Society,158,Contenders,2020,0,30,general,Middle
1577,1992,28,MacArthur Fellowship,35,Contenders,2020,0,28,general,Middle
1578,2009,10,Fellow of the Royal Society,1048,Contenders,2019,0,10,general,Middle
1579,2002,17,Shanti Swarup Bhatnagar Prize for Science and Technology,869,Contenders,2019,0,17,general,Young
1580,2000,20,Fellow of the Royal Society,270,Contenders,2020,0,20,general,Senior
1581,2001,18,Fellow of the Royal Society,1302,Contenders,2019,0,18,general,Middle
1582,2017,3,Breakthrough Prize in Life Sciences,374,Contenders,2020,0,3,biology,Senior
1583,2010,9,Fellow of the Royal Society,272,Contenders,2019,0,9,general,Middle
1584,2009,11,Fellow of the Royal Society,57,Contenders,2020,0,11,general,Young
1586,2009,11,Fellow of the Royal Society,398,Contenders,2020,0,11,general,Middle
1587,2018,2,Wolf Prize in Chemistry,764,Contenders,2020,0,2,chemistry,Senior
1588,1986,7,Max Planck Medal,250,Contenders,1993,1,7,physics,Middle
1589,2013,4,SASTRA Ramanujan Prize,829,Contenders,2017,1,4,mathematics,Young
1590,2012,8,Fellow of the Royal Society,783,Contenders,2020,0,8,general,Middle
1591,1998,21,Fellow of the Royal Society,612,Contenders,2019,0,21,general,Young
1592,2010,8,MacArthur Fellowship,1421,Contenders,2018,0,8,general,Young
1594,2003,7,MacArthur Fellowship,1362,Contenders,2010,1,7,general,Young
1596,2011,9,Fellow of the Royal Society,1022,Contenders,2020,0,9,general,NA
1597,2016,4,Fellow of the Royal Society,803,Contenders,2020,0,4,general,NA
1598,2008,11,MacArthur Fellowship,743,Contenders,2019,0,11,general,Young
1599,2001,19,Fellow of the Royal Society,986,Contenders,2020,0,19,general,Middle
1600,1983,28,Wolf Prize in Chemistry,1352,Contenders,2011,1,28,chemistry,Middle
1601,2000,6,Shanti Swarup Bhatnagar Prize for Science and Technology,767,Contenders,2006,1,6,general,Young
1602,1982,28,Nobel Prize in Physiology or Medicine,197,Contenders,2010,1,28,biology,Middle
1603,2014,6,Fields Medal,605,Contenders,2020,0,6,mathematics,Young
1604,2003,15,Fellow of the Royal Society,842,Contenders,2018,0,15,general,Middle
1605,2013,5,Nobel Prize in Physiology or Medicine,284,Contenders,2018,0,5,biology,Senior
1606,2006,14,Shanti Swarup Bhatnagar Prize for Science and Technology,895,Contenders,2020,0,14,general,NA
1607,2014,6,Breakthrough Prize in Life Sciences,1004,Contenders,2020,0,6,biology,Senior
1608,2014,6,Willard Gibbs Award,195,Contenders,2020,0,6,chemistry,Senior
1609,2006,14,National Medal of Science,665,Contenders,2020,0,14,general,Senior
1610,1991,23,MacArthur Fellowship,724,Contenders,2014,1,23,general,Young
1612,1993,26,Wolf Prize in Mathematics,401,Contenders,2019,0,26,mathematics,Middle
1613,2016,2,Wolf Prize in Medicine,978,Contenders,2018,0,2,biology,Senior
1614,1984,19,Nobel Prize in Physics,666,Contenders,2003,1,19,physics,Middle
1615,1989,30,Nobel Prize in Physiology or Medicine,155,Contenders,2019,0,30,biology,Middle
1616,2002,18,MacArthur Fellowship,28,Contenders,2020,0,18,general,Young
1617,1973,47,Shanti Swarup Bhatnagar Prize for Science and Technology,1192,Contenders,2020,0,47,general,Young
1618,2004,16,Fellow of the Royal Society,368,Contenders,2020,0,16,general,Middle
1619,1980,36,Fellow of the Royal Society,127,Contenders,2016,1,36,general,Middle
1620,2009,10,Fellow of the Royal Society,539,Contenders,2019,0,10,general,NA
1621,1977,29,Shanti Swarup Bhatnagar Prize for Science and Technology,851,Contenders,2006,1,29,general,Young
1622,2014,6,Nobel Prize in Physiology or Medicine,1045,Contenders,2020,0,6,biology,Middle
1623,1997,22,MacArthur Fellowship,600,Contenders,2019,0,22,general,Young
1624,2000,20,Shanti Swarup Bhatnagar Prize for Science and Technology,418,Contenders,2020,0,20,general,NA
1625,2013,6,Fellow of the Royal Society,336,Contenders,2019,0,6,general,Middle
1626,2000,17,Fellow of the Royal Society,1281,Contenders,2017,1,17,general,Senior
1627,2014,4,Wolf Prize in Mathematics,459,Contenders,2018,0,4,mathematics,Senior
1628,2015,4,Vautrin Lud Prize,295,Contenders,2019,0,4,geography,Senior
1629,2007,9,Fellow of the Royal Society,550,Contenders,2016,1,9,general,NA
1630,2015,4,Max Planck Medal,287,Contenders,2019,0,4,physics,Middle
1631,2007,13,Fellow of the Royal Society,147,Contenders,2020,0,13,general,Middle
1632,1997,18,Fellow of the Royal Society,1006,Contenders,2015,1,18,general,Middle
1633,1947,32,Fellow of the Royal Society,495,Contenders,1979,1,32,general,Middle
1634,1982,37,MacArthur Fellowship,1330,Contenders,2019,0,37,general,Young
1635,2004,12,Shanti Swarup Bhatnagar Prize for Science and Technology,1291,Contenders,2016,1,12,general,Young
1636,1979,40,Fellow of the Royal Society,615,Contenders,2019,0,40,general,Young
1637,2004,2,Nobel Prize in Chemistry,1341,Contenders,2006,1,2,chemistry,Senior
1638,2015,3,Nobel Prize in Chemistry,123,Contenders,2018,0,3,chemistry,Senior
1639,2005,7,Wolf Prize in Medicine,126,Contenders,2012,1,7,biology,Senior
1640,1995,12,MacArthur Fellowship,129,Contenders,2007,1,12,general,Young
1641,2007,13,Fellow of the Royal Society,968,Contenders,2020,0,13,general,Senior
1642,1981,29,Nobel Prize in Chemistry,593,Contenders,2010,1,29,chemistry,Senior
1643,2008,12,MacArthur Fellowship,743,Contenders,2020,0,12,general,Young
1644,2001,1,Wolf Prize in Medicine,251,Contenders,2002,1,1,biology,Senior
1645,2005,15,Fellow of the Royal Society,334,Contenders,2020,0,15,general,Middle
1646,2009,11,National Medal of Science,928,Contenders,2020,0,11,general,Middle
1647,2000,17,Nobel Prize in Chemistry,579,Contenders,2017,1,17,chemistry,Senior
1648,2018,1,Fellow of the Royal Society,607,Contenders,2019,0,1,general,Senior
1649,2009,10,Nobel Prize in Physics,1197,Contenders,2019,0,10,physics,Senior
1650,1993,23,Fellow of the Royal Society,996,Contenders,2016,1,23,general,Young
1651,2014,5,Shanti Swarup Bhatnagar Prize for Science and Technology,1098,Contenders,2019,0,5,general,Young
1652,1972,12,Nobel Prize in Physics,811,Contenders,1984,1,12,physics,Young
1653,1944,17,Fellow of the Royal Society,669,Contenders,1961,1,17,general,Middle
1654,1993,27,Fellow of the Royal Society,1016,Contenders,2020,0,27,general,Middle
1655,1983,25,MacArthur Fellowship,885,Contenders,2008,1,25,general,Young
1656,1995,13,National Medal of Science,1211,Contenders,2008,1,13,general,Middle
1657,2016,4,Fellow of the Royal Society,96,Contenders,2020,0,4,general,Middle
1658,2014,5,Willard Gibbs Award,195,Contenders,2019,0,5,chemistry,Senior
1659,2001,18,Fellow of the Royal Society,76,Contenders,2019,0,18,general,Middle
1660,1990,30,Fellow of the Royal Society,519,Contenders,2020,0,30,general,NA
1661,2000,20,MacArthur Fellowship,278,Contenders,2020,0,20,general,Young
1662,2009,10,Fellow of the Royal Society,57,Contenders,2019,0,10,general,Young
1663,1983,12,MacArthur Fellowship,871,Contenders,1995,1,12,general,Middle
1664,1986,31,Fellow of the Royal Society,414,Contenders,2017,1,31,general,Young
1665,1998,19,Fellow of the Royal Society,88,Contenders,2017,1,19,general,Middle
1666,1987,33,Shanti Swarup Bhatnagar Prize for Science and Technology,721,Contenders,2020,0,33,general,Young
1667,2001,16,Nobel Prize in Physics,323,Contenders,2017,1,16,physics,Middle
1668,2000,19,Shanti Swarup Bhatnagar Prize for Science and Technology,714,Contenders,2019,0,19,general,NA
1669,1979,32,Fellow of the Royal Society,1037,Contenders,2011,1,32,general,Young
1670,1967,10,Fellow of the Royal Society,1423,Contenders,1977,1,10,general,Young
1671,1982,32,Fellow of the Royal Society,703,Contenders,2014,1,32,general,Middle
1672,2014,6,Nobel Prize in Physics,921,Contenders,2020,0,6,physics,Middle
1673,1996,19,Fellow of the Royal Society,538,Contenders,2015,1,19,general,Middle
1674,1996,17,Fellow of the Royal Society,229,Contenders,2013,1,17,general,Young
1675,1996,1,Shanti Swarup Bhatnagar Prize for Science and Technology,421,Contenders,1997,1,1,general,Young
1678,2005,15,Fellow of the Royal Society,917,Contenders,2020,0,15,general,Middle
1679,1993,27,Shanti Swarup Bhatnagar Prize for Science and Technology,640,Contenders,2020,0,27,general,Young
1680,2000,20,Shanti Swarup Bhatnagar Prize for Science and Technology,418,Contenders,2020,0,20,general,NA
1681,1987,29,Shanti Swarup Bhatnagar Prize for Science and Technology,721,Contenders,2016,1,29,general,Young
1682,1968,27,Fellow of the Royal Society,1245,Contenders,1995,1,27,general,Middle
1683,1993,23,Fellow of the Royal Society,1051,Contenders,2016,1,23,general,Young
1684,1996,20,Fellow of the Royal Society,538,Contenders,2016,1,20,general,Middle
1685,1981,37,Fellow of the Royal Society,1067,Contenders,2018,0,37,general,Young
1687,2009,6,Shanti Swarup Bhatnagar Prize for Science and Technology,813,Contenders,2015,1,6,general,Young
1688,1980,39,Fellow of the Royal Society,127,Contenders,2019,0,39,general,Middle
1689,1980,38,Fellow of the Royal Society,1295,Contenders,2018,0,38,general,Middle
1690,2004,16,National Medal of Science,18,Contenders,2020,0,16,general,Senior
1691,1983,36,MacArthur Fellowship,1325,Contenders,2019,0,36,general,Middle
1692,1982,21,MacArthur Fellowship,536,Contenders,2003,1,21,general,Young
1693,1993,26,Fellow of the Royal Society,361,Contenders,2019,0,26,general,Middle
1694,1967,50,Bigsby Medal,751,Contenders,2017,1,50,geography,Young
1695,2010,10,Fellow of the Royal Society,271,Contenders,2020,0,10,general,Middle
1696,1997,21,Shanti Swarup Bhatnagar Prize for Science and Technology,341,Contenders,2018,0,21,general,Young
1697,1997,23,MacArthur Fellowship,223,Contenders,2020,0,23,general,Middle
1698,1993,21,Fellow of the Royal Society,826,Contenders,2014,1,21,general,NA
1699,2001,19,Shanti Swarup Bhatnagar Prize for Science and Technology,285,Contenders,2020,0,19,general,Young
1700,2001,12,Wolf Prize in Chemistry,1222,Contenders,2013,1,12,chemistry,Senior
1701,2010,3,Willard Gibbs Award,131,Contenders,2013,1,3,chemistry,Senior
1702,2001,19,Shanti Swarup Bhatnagar Prize for Science and Technology,1317,Contenders,2020,0,19,general,Young
1703,1991,25,MacArthur Fellowship,533,Contenders,2016,1,25,general,Middle
1704,2005,14,Fellow of the Royal Society,1079,Contenders,2019,0,14,general,Senior
1705,1984,31,Nobel Prize in Chemistry,573,Contenders,2015,1,31,chemistry,Senior
1706,1997,22,MacArthur Fellowship,792,Contenders,2019,0,22,general,Young
1708,2008,11,Fellow of the Royal Society,447,Contenders,2019,0,11,general,Middle
1709,2015,2,Fellow of the Royal Society,727,Contenders,2017,1,2,general,Senior
1710,2002,15,National Medal of Science,1208,Contenders,2017,1,15,general,Senior
1711,1994,1,Lasker-DeBakey Clinical Medical Research Award,1329,Contenders,1995,1,1,biology,Senior
1712,2018,2,Fellow of the Royal Society,516,Contenders,2020,0,2,general,Middle
1713,1986,33,Fellow of the Royal Society,99,Contenders,2019,0,33,general,Young
1714,2000,17,MacArthur Fellowship,153,Contenders,2017,1,17,general,Middle
1715,2004,16,Nobel Prize in Chemistry,187,Contenders,2020,0,16,chemistry,Middle
1716,2014,2,Fellow of the Royal Society,1213,Contenders,2016,1,2,general,Senior
1717,2012,8,Fellow of the Royal Society,747,Contenders,2020,0,8,general,Middle
1718,2007,11,Fellow of the Royal Society,27,Contenders,2018,0,11,general,Young
1719,2000,20,MacArthur Fellowship,61,Contenders,2020,0,20,general,Young
1720,2003,17,Shanti Swarup Bhatnagar Prize for Science and Technology,1010,Contenders,2020,0,17,general,Middle
1721,1984,34,MacArthur Fellowship,1402,Contenders,2018,0,34,general,Young
1722,2012,7,Nobel Prize in Physics,1078,Contenders,2019,0,7,physics,Senior
1723,1986,12,Fellow of the Royal Society,1392,Contenders,1998,1,12,general,Young
1724,1987,11,Fellow of the Royal Society,621,Contenders,1998,1,11,general,Middle
1725,2015,5,Fellow of the Royal Society,264,Contenders,2020,0,5,general,Senior
1726,2002,17,Fellow of the Royal Society,216,Contenders,2019,0,17,general,Middle
1727,1966,14,Fellow of the Royal Society,144,Contenders,1980,1,14,general,Young
1728,1982,31,MacArthur Fellowship,1330,Contenders,2013,1,31,general,Young
1729,2015,5,MacArthur Fellowship,507,Contenders,2020,0,5,general,Young
1730,1981,6,MacArthur Fellowship,45,Contenders,1987,1,6,general,Young
1731,2004,15,Shanti Swarup Bhatnagar Prize for Science and Technology,446,Contenders,2019,0,15,general,Young
1732,1994,22,Wolf Prize in Chemistry,894,Contenders,2016,1,22,chemistry,Young
1733,1983,32,Wolf Prize in Chemistry,1008,Contenders,2015,1,32,chemistry,Middle
1734,1992,23,Nobel Prize in Physiology or Medicine,1034,Contenders,2015,1,23,biology,Senior
1735,1989,25,Shanti Swarup Bhatnagar Prize for Science and Technology,1316,Contenders,2014,1,25,general,Young
1736,1987,5,MacArthur Fellowship,526,Contenders,1992,1,5,general,Young
1737,1989,31,Fellow of the Royal Society,1234,Contenders,2020,0,31,general,Young
1738,2002,18,Fellow of the Royal Society,518,Contenders,2020,0,18,general,Middle
1739,1975,2,Nobel Prize in Physics,1235,Contenders,1977,1,2,physics,Middle
1740,1993,24,Fellow of the Royal Society,1016,Contenders,2017,1,24,general,Middle
1741,2017,3,Fellow of the Royal Society,1236,Contenders,2020,0,3,general,Senior
1742,1949,17,Hughes Medal,1320,Contenders,1966,1,17,physics,Middle
1743,2010,9,Shanti Swarup Bhatnagar Prize for Science and Technology,594,Contenders,2019,0,9,general,Young
1745,1988,26,Shanti Swarup Bhatnagar Prize for Science and Technology,1347,Contenders,2014,1,26,general,Young
1746,2001,19,Nobel Prize in Physics,730,Contenders,2020,0,19,physics,Young
1747,2002,18,Nobel Prize in Chemistry,1355,Contenders,2020,0,18,chemistry,Young
1748,1992,27,Fellow of the Royal Society,1267,Contenders,2019,0,27,general,Middle
1749,1983,19,Fellow of the Royal Society,370,Contenders,2002,1,19,general,Young
1750,2015,4,SASTRA Ramanujan Prize,15,Contenders,2019,0,4,mathematics,Young
1751,2017,3,Fellow of the Royal Society,769,Contenders,2020,0,3,general,NA
1752,2011,8,Fellow of the Royal Society,509,Contenders,2019,0,8,general,Middle
1753,1987,18,MacArthur Fellowship,613,Contenders,2005,1,18,general,Middle
1754,1995,23,Nobel Prize in Physiology or Medicine,157,Contenders,2018,0,23,biology,Middle
1755,2003,16,Shanti Swarup Bhatnagar Prize for Science and Technology,1163,Contenders,2019,0,16,general,Young
1756,1980,15,Edison Medal,1195,Contenders,1995,1,15,cs,Senior
1757,2011,9,Fellow of the Royal Society,1407,Contenders,2020,0,9,general,Senior
1758,2011,8,National Medal of Science,683,Contenders,2019,0,8,general,Senior
1759,2004,16,National Medal of Science,18,Contenders,2020,0,16,general,Senior
1760,1989,29,Fellow of the Royal Society,1171,Contenders,2018,0,29,general,Middle
1761,2005,15,MacArthur Fellowship,146,Contenders,2020,0,15,general,Young
1762,2011,9,Fellow of the Royal Society,1180,Contenders,2020,0,9,general,Young
1763,2006,14,Shanti Swarup Bhatnagar Prize for Science and Technology,30,Contenders,2020,0,14,general,Young
1764,1968,38,Nobel Prize in Physiology or Medicine,290,Contenders,2006,1,38,biology,Middle
1765,1983,8,Fellow of the Royal Society,693,Contenders,1991,1,8,general,Middle
1766,2006,13,Fields Medal,111,Contenders,2019,0,13,mathematics,Young
1767,1998,7,Wolf Prize in Medicine,565,Contenders,2005,1,7,biology,Senior
1768,2011,0,Fellow of the Royal Society,820,Contenders,2011,1,0,general,Middle
1769,1991,27,Fellow of the Royal Society,1307,Contenders,2018,0,27,general,Middle
1770,2007,13,Shanti Swarup Bhatnagar Prize for Science and Technology,1041,Contenders,2020,0,13,general,Young
1771,1997,13,Shanti Swarup Bhatnagar Prize for Science and Technology,241,Contenders,2010,1,13,general,Young
1772,1988,14,Fellow of the Royal Society,201,Contenders,2002,1,14,general,Middle
1773,1997,23,Nobel Prize in Physics,7,Contenders,2020,0,23,physics,Senior
1774,1998,22,Fellow of the Royal Society,492,Contenders,2020,0,22,general,Middle
1775,1995,24,National Medal of Science,1211,Contenders,2019,0,24,general,Middle
1776,1999,0,MacArthur Fellowship,517,Contenders,1999,1,0,general,Young
1777,2009,11,Fellow of the Royal Society,57,Contenders,2020,0,11,general,Young
1778,2000,17,Shanti Swarup Bhatnagar Prize for Science and Technology,714,Contenders,2017,1,17,general,NA
1779,1999,21,Fellow of the Royal Society,42,Contenders,2020,0,21,general,Middle
1780,1996,24,Fellow of the Royal Society,327,Contenders,2020,0,24,general,Middle
1781,1989,28,Nobel Prize in Chemistry,80,Contenders,2017,1,28,chemistry,Young
1782,2009,11,Shanti Swarup Bhatnagar Prize for Science and Technology,813,Contenders,2020,0,11,general,Young
1783,2002,5,Shanti Swarup Bhatnagar Prize for Science and Technology,734,Contenders,2007,1,5,general,Middle
1784,2010,9,Shanti Swarup Bhatnagar Prize for Science and Technology,116,Contenders,2019,0,9,general,Young
1785,1967,24,Shanti Swarup Bhatnagar Prize for Science and Technology,1393,Contenders,1991,1,24,general,Young
1786,1992,23,Fellow of the Royal Society,1046,Contenders,2015,1,23,general,Middle
1787,1999,21,MacArthur Fellowship,104,Contenders,2020,0,21,general,Young
1788,1994,19,MacArthur Fellowship,191,Contenders,2013,1,19,general,Young
1789,1966,24,Nobel Prize in Physics,403,Contenders,1990,1,24,physics,Senior
1790,2001,19,Fellow of the Royal Society,128,Contenders,2020,0,19,general,Middle
1791,2000,5,Edison Medal,1124,Contenders,2005,1,5,cs,Senior
1792,1986,33,Shanti Swarup Bhatnagar Prize for Science and Technology,366,Contenders,2019,0,33,general,Young
1793,2014,5,Fellow of the Royal Society,1036,Contenders,2019,0,5,general,NA
1794,2015,4,MacArthur Fellowship,862,Contenders,2019,0,4,general,NA
1795,2006,14,Fellow of the Royal Society,873,Contenders,2020,0,14,general,Middle
1796,1965,29,Shanti Swarup Bhatnagar Prize for Science and Technology,1450,Contenders,1994,1,29,general,Young
1797,1984,29,MacArthur Fellowship,1080,Contenders,2013,1,29,general,Young
1798,1991,6,Fellow of the Royal Society,394,Contenders,1997,1,6,general,Middle
1799,1976,42,Nobel Prize in Physics,924,Contenders,2018,0,42,physics,Young
1800,1990,26,MacArthur Fellowship,156,Contenders,2016,1,26,general,Middle
1801,1992,26,Edison Medal,1074,Contenders,2018,0,26,cs,Middle
1802,2001,15,Shanti Swarup Bhatnagar Prize for Science and Technology,108,Contenders,2016,1,15,general,Young
1803,1972,41,Shanti Swarup Bhatnagar Prize for Science and Technology,798,Contenders,2013,1,41,general,Young
1804,2000,19,Fellow of the Royal Society,787,Contenders,2019,0,19,general,Middle
1805,1977,30,Fellow of the Royal Society,984,Contenders,2007,1,30,general,Middle
1806,1993,23,MacArthur Fellowship,1443,Contenders,2016,1,23,general,Young
1807,1983,37,MacArthur Fellowship,299,Contenders,2020,0,37,general,Young
1808,1973,45,Fellow of the Royal Society,1109,Contenders,2018,0,45,general,Young
1809,2011,9,Nobel Prize in Physics,454,Contenders,2020,0,9,physics,Middle
1810,2015,5,Fellow of the Royal Society,529,Contenders,2020,0,5,general,NA
1811,2006,14,Fellow of the Royal Society,599,Contenders,2020,0,14,general,Young
1812,2011,9,Fellow of the Royal Society,19,Contenders,2020,0,9,general,NA
1813,1989,28,Turing Award,508,Contenders,2017,1,28,cs,Middle
1814,1971,48,Fellow of the Royal Society,1230,Contenders,2019,0,48,general,Young
1815,1981,39,Fellow of the Royal Society,628,Contenders,2020,0,39,general,Middle
1816,1993,15,Shanti Swarup Bhatnagar Prize for Science and Technology,1242,Contenders,2008,1,15,general,Young
1817,1993,26,Max Planck Medal,400,Contenders,2019,0,26,physics,Middle
1818,1998,21,Fields Medal,466,Contenders,2019,0,21,mathematics,Young
1819,2007,13,Fellow of the Royal Society,649,Contenders,2020,0,13,general,Senior
1820,2008,0,Nobel Prize in Physiology or Medicine,24,Contenders,2008,1,0,biology,Senior
1821,1983,35,MacArthur Fellowship,871,Contenders,2018,0,35,general,Middle
1822,1986,32,Nobel Prize in Chemistry,402,Contenders,2018,0,32,chemistry,Middle
1823,1983,37,MacArthur Fellowship,885,Contenders,2020,0,37,general,Young
1825,1997,23,National Medal of Science,911,Contenders,2020,0,23,general,Middle
1826,1997,22,MacArthur Fellowship,217,Contenders,2019,0,22,general,NA
1827,2018,2,Wolf Prize in Chemistry,764,Contenders,2020,0,2,chemistry,Senior
1828,2015,5,Fellow of the Royal Society,344,Contenders,2020,0,5,general,Young
1829,2004,16,Fellow of the Royal Society,804,Contenders,2020,0,16,general,Middle
1830,1996,9,Shanti Swarup Bhatnagar Prize for Science and Technology,383,Contenders,2005,1,9,general,Young
1831,2006,13,Fellow of the Royal Society,1139,Contenders,2019,0,13,general,Middle
1832,2002,17,Fellow of the Royal Society,1427,Contenders,2019,0,17,general,Middle
1833,2005,11,Fellow of the Royal Society,738,Contenders,2016,1,11,general,Senior
1834,1983,37,MacArthur Fellowship,39,Contenders,2020,0,37,general,Young
1836,2003,14,Shanti Swarup Bhatnagar Prize for Science and Technology,1163,Contenders,2017,1,14,general,Young
1837,1968,25,Fellow of the Royal Society,967,Contenders,1993,1,25,general,Young
1839,2008,7,MacArthur Fellowship,462,Contenders,2015,1,7,general,Young
1840,2003,17,Nobel Prize in Chemistry,1283,Contenders,2020,0,17,chemistry,Middle
1841,2010,10,Shanti Swarup Bhatnagar Prize for Science and Technology,923,Contenders,2020,0,10,general,Young
1842,2018,2,Breakthrough Prize in Life Sciences,590,Contenders,2020,0,2,biology,Senior
1843,1986,12,Lasker-DeBakey Clinical Medical Research Award,1460,Contenders,1998,1,12,biology,Middle
1844,2001,18,Willard Gibbs Award,935,Contenders,2019,0,18,chemistry,Middle
1845,2005,14,Nobel Prize in Chemistry,359,Contenders,2019,0,14,chemistry,Senior
1846,2003,17,Fellow of the Royal Society,789,Contenders,2020,0,17,general,Middle
1847,2008,12,Fellow of the Royal Society,447,Contenders,2020,0,12,general,Middle
1848,1999,20,MacArthur Fellowship,73,Contenders,2019,0,20,general,Young
1849,1978,28,Fellow of the Royal Society,1413,Contenders,2006,1,28,general,Senior
1850,2005,15,Shanti Swarup Bhatnagar Prize for Science and Technology,456,Contenders,2020,0,15,general,Young
1851,1931,10,Nobel Prize in Physiology or Medicine,210,Contenders,1941,1,10,biology,Middle
1852,2006,13,Fellow of the Royal Society,1358,Contenders,2019,0,13,general,Senior
1853,2004,16,Fellow of the Royal Society,477,Contenders,2020,0,16,general,Middle
1854,2001,18,Fellow of the Royal Society,1288,Contenders,2019,0,18,general,Middle
1855,2001,18,Shanti Swarup Bhatnagar Prize for Science and Technology,1317,Contenders,2019,0,18,general,Young
1856,2017,3,Fellow of the Royal Society,1042,Contenders,2020,0,3,general,NA
1857,1970,11,Fellow of the Royal Society,1081,Contenders,1981,1,11,general,Middle
1858,2006,14,Fellow of the Royal Society,873,Contenders,2020,0,14,general,Middle
1859,1997,21,Nobel Prize in Physics,7,Contenders,2018,0,21,physics,Senior
1860,2004,16,Fellow of the Royal Society,619,Contenders,2020,0,16,general,Middle
1861,1999,20,National Medal of Science,597,Contenders,2019,0,20,general,Senior
1862,1971,37,Fellow of the Royal Society,667,Contenders,2008,1,37,general,Young
1863,1986,33,Fields Medal,1142,Contenders,2019,0,33,mathematics,Young
1864,1967,49,Albert Einstein Award,824,Contenders,2016,1,49,physics,Young
1866,2018,2,Fellow of the Royal Society,286,Contenders,2020,0,2,general,Senior
1867,2008,11,MacArthur Fellowship,432,Contenders,2019,0,11,general,Young
1868,2007,6,Fellow of the Royal Society,387,Contenders,2013,1,6,general,Middle
1869,2008,12,Fellow of the Royal Society,163,Contenders,2020,0,12,general,NA
1870,1980,28,Wolf Prize in Medicine,484,Contenders,2008,1,28,biology,Middle
1871,2012,3,Fellow of the Royal Society,819,Contenders,2015,1,3,general,Senior
1872,1995,24,Nobel Prize in Physiology or Medicine,157,Contenders,2019,0,24,biology,Middle
1873,1978,29,Fellow of the Royal Society,1413,Contenders,2007,1,29,general,Senior
1874,1996,24,Shanti Swarup Bhatnagar Prize for Science and Technology,1250,Contenders,2020,0,24,general,Young
1875,1989,30,Nobel Prize in Chemistry,1130,Contenders,2019,0,30,chemistry,Middle
1876,2015,5,Fellow of the Royal Society,330,Contenders,2020,0,5,general,Middle
1878,1993,25,Shanti Swarup Bhatnagar Prize for Science and Technology,586,Contenders,2018,0,25,general,Young
1879,1983,25,Fellow of the Royal Society,1438,Contenders,2008,1,25,general,Middle
1880,2006,5,MacArthur Fellowship,385,Contenders,2011,1,5,general,Young
1881,1982,15,MacArthur Fellowship,728,Contenders,1997,1,15,general,Young
1882,1995,24,Fellow of the Royal Society,1433,Contenders,2019,0,24,general,Middle
1883,1975,27,Shanti Swarup Bhatnagar Prize for Science and Technology,1085,Contenders,2002,1,27,general,Young
1884,2017,2,Breakthrough Prize in Life Sciences,374,Contenders,2019,0,2,biology,Senior
1885,1999,21,Fellow of the Royal Society,1228,Contenders,2020,0,21,general,NA
1886,2016,4,Fellow of the Royal Society,971,Contenders,2020,0,4,general,Middle
1887,1993,26,Fellow of the Royal Society,1016,Contenders,2019,0,26,general,Middle
1888,1953,66,Nobel Prize in Chemistry,1058,Contenders,2019,0,66,chemistry,Senior
1890,2011,8,Fellow of the Royal Society,65,Contenders,2019,0,8,general,Middle
1891,1981,38,MacArthur Fellowship,717,Contenders,2019,0,38,general,Young
1892,1992,27,MacArthur Fellowship,35,Contenders,2019,0,27,general,Middle
1893,1998,19,Vautrin Lud Prize,887,Contenders,2017,1,19,geography,Middle
1894,1973,23,Fellow of the Royal Society,860,Contenders,1996,1,23,general,Young
1895,1991,29,National Medal of Science,1372,Contenders,2020,0,29,general,Middle
1896,1975,26,Shanti Swarup Bhatnagar Prize for Science and Technology,1348,Contenders,2001,1,26,general,Young
1897,2006,14,Shanti Swarup Bhatnagar Prize for Science and Technology,895,Contenders,2020,0,14,general,NA
1899,1982,30,Fields Medal,1174,Contenders,2012,1,30,mathematics,Young
1900,2000,20,MacArthur Fellowship,61,Contenders,2020,0,20,general,Young
1901,2008,12,MacArthur Fellowship,743,Contenders,2020,0,12,general,Young
1902,2001,13,Max Planck Medal,918,Contenders,2014,1,13,physics,Middle
1903,2007,13,Max Planck Medal,1303,Contenders,2020,0,13,physics,Senior
1905,1998,21,MacArthur Fellowship,304,Contenders,2019,0,21,general,NA
1906,2008,11,Max Planck Medal,1366,Contenders,2019,0,11,physics,Senior
1907,1986,24,Fellow of the Royal Society,1027,Contenders,2010,1,24,general,Middle
1908,2015,5,Fellow of the Royal Society,901,Contenders,2020,0,5,general,Middle
1909,1972,31,Fellow of the Royal Society,696,Contenders,2003,1,31,general,Middle
1910,1986,16,National Medal of Science,1254,Contenders,2002,1,16,general,Senior
1913,1983,22,MacArthur Fellowship,1325,Contenders,2005,1,22,general,Middle
1915,2014,6,Nobel Prize in Physiology or Medicine,1045,Contenders,2020,0,6,biology,Middle
1916,2006,12,Fellow of the Royal Society,855,Contenders,2018,0,12,general,Middle
1917,2000,17,Edison Medal,1124,Contenders,2017,1,17,cs,Senior
1918,2009,2,Fellow of the Royal Society,448,Contenders,2011,1,2,general,Senior
1919,1984,2,MacArthur Fellowship,354,Contenders,1986,1,2,general,Young
1920,1990,30,Shanti Swarup Bhatnagar Prize for Science and Technology,888,Contenders,2020,0,30,general,Young
1921,1967,32,Fellow of the Royal Society,1423,Contenders,1999,1,32,general,Young
1922,1983,11,Fellow of the Royal Society,1214,Contenders,1994,1,11,general,Young
1923,2004,15,Fellow of the Royal Society,1096,Contenders,2019,0,15,general,Middle
1924,1997,22,Fellow of the Royal Society,3,Contenders,2019,0,22,general,Middle
1925,1942,35,Fellow of the Royal Society,1158,Contenders,1977,1,35,general,Young
1926,1980,33,Shanti Swarup Bhatnagar Prize for Science and Technology,1466,Contenders,2013,1,33,general,Young
1927,2008,12,Fellow of the Royal Society,581,Contenders,2020,0,12,general,Senior
1928,2002,8,MacArthur Fellowship,62,Contenders,2010,1,8,general,Young
1929,1997,21,Fellow of the Royal Society,975,Contenders,2018,0,21,general,Young
1930,2012,8,MacArthur Fellowship,4,Contenders,2020,0,8,general,Young
1931,1993,22,Shanti Swarup Bhatnagar Prize for Science and Technology,1242,Contenders,2015,1,22,general,Young
1932,1994,19,Fellow of the Royal Society,548,Contenders,2013,1,19,general,Middle
1933,2003,14,Fellow of the Royal Society,1137,Contenders,2017,1,14,general,Middle
1934,1995,24,Marconi Prize,246,Contenders,2019,0,24,cs,Senior
1936,2002,17,Wolf Prize in Medicine,1,Contenders,2019,0,17,biology,Senior
1937,2008,12,Nobel Prize in Physiology or Medicine,397,Contenders,2020,0,12,biology,Senior
1938,1993,27,Fellow of the Royal Society,361,Contenders,2020,0,27,general,Middle
1939,1991,15,Fellow of the Royal Society,282,Contenders,2006,1,15,general,Young
1940,1984,36,Fellow of the Royal Society,20,Contenders,2020,0,36,general,Young
1941,2009,11,Willard Gibbs Award,981,Contenders,2020,0,11,chemistry,Senior
1942,1994,16,Fields Medal,138,Contenders,2010,1,16,mathematics,Young
1943,2002,8,Fellow of the Royal Society,440,Contenders,2010,1,8,general,Middle
1944,2013,7,Fellow of the Royal Society,1055,Contenders,2020,0,7,general,Middle
1945,2005,15,MacArthur Fellowship,671,Contenders,2020,0,15,general,Young
1946,2000,19,Fellow of the Royal Society,1205,Contenders,2019,0,19,general,Middle
1947,1994,17,National Medal of Science,1397,Contenders,2011,1,17,general,Senior
1948,2015,5,Fellow of the Royal Society,337,Contenders,2020,0,5,general,Middle
1949,1996,23,Nobel Prize in Physiology or Medicine,100,Contenders,2019,0,23,biology,Middle
1950,1996,23,Fellow of the Royal Society,850,Contenders,2019,0,23,general,Middle
1951,1950,12,Fellow of the Royal Society,1435,Contenders,1962,1,12,general,Young
1952,2000,6,MacArthur Fellowship,153,Contenders,2006,1,6,general,Middle
1953,1987,25,Fellow of the Royal Society,1185,Contenders,2012,1,25,general,Young
1954,2010,4,Fields Medal,40,Contenders,2014,1,4,mathematics,Young
1955,1998,22,Nobel Prize in Physics,369,Contenders,2020,0,22,physics,Middle
1956,2012,8,Fellow of the Royal Society,371,Contenders,2020,0,8,general,Young
1957,1967,6,Nobel Prize in Chemistry,682,Contenders,1973,1,6,chemistry,Young
1958,1987,33,Nobel Prize in Physiology or Medicine,36,Contenders,2020,0,33,biology,Middle
1959,1991,7,National Medal of Science,633,Contenders,1998,1,7,general,Senior
1960,2012,8,Abel Prize,877,Contenders,2020,0,8,mathematics,Senior
1961,2001,19,Fellow of the Royal Society,1210,Contenders,2020,0,19,general,Young
1962,2009,7,Fellow of the Royal Society,475,Contenders,2016,1,7,general,NA
1963,2010,6,Wolf Prize in Physics,1318,Contenders,2016,1,6,physics,Senior
1964,2012,8,Turing Award,228,Contenders,2020,0,8,cs,Middle
1965,2010,3,Shanti Swarup Bhatnagar Prize for Science and Technology,791,Contenders,2013,1,3,general,Young
1966,1987,33,MacArthur Fellowship,151,Contenders,2020,0,33,general,Young
1967,2004,13,Fellow of the Royal Society,1117,Contenders,2017,1,13,general,Senior
1968,1996,24,Fellow of the Royal Society,913,Contenders,2020,0,24,general,Middle
1969,1954,48,Fellow of the Royal Society,582,Contenders,2002,1,48,general,Young
1970,1963,39,Willard Gibbs Award,756,Contenders,2002,1,39,chemistry,Middle
1971,1982,20,Willard Gibbs Award,1422,Contenders,2002,1,20,chemistry,Senior
1972,2004,16,Fellow of the Royal Society,1096,Contenders,2020,0,16,general,Middle
1973,1987,21,Fellow of the Royal Society,859,Contenders,2008,1,21,general,Middle
1974,2002,17,Nobel Prize in Physiology or Medicine,119,Contenders,2019,0,17,biology,Middle
1975,1968,41,Nobel Prize in Physiology or Medicine,1200,Contenders,2009,1,41,biology,Middle
1976,1992,28,Fellow of the Royal Society,267,Contenders,2020,0,28,general,Young
1977,1980,35,Fellow of the Royal Society,1295,Contenders,2015,1,35,general,Middle
1978,1998,17,Lasker-DeBakey Clinical Medical Research Award,209,Contenders,2015,1,17,biology,Senior
1979,2005,14,Fellow of the Royal Society,656,Contenders,2019,0,14,general,Middle
1980,1996,24,Fellow of the Royal Society,913,Contenders,2020,0,24,general,Middle
1981,2017,3,Nobel Prize in Physiology or Medicine,1088,Contenders,2020,0,3,biology,Senior
1984,2001,17,Nobel Prize in Physiology or Medicine,742,Contenders,2018,0,17,biology,Middle
1985,1987,33,MacArthur Fellowship,266,Contenders,2020,0,33,general,Young
1986,1990,28,National Medal of Science,494,Contenders,2018,0,28,general,Middle
1987,2002,16,Fellow of the Royal Society,1033,Contenders,2018,0,16,general,Middle
1988,1998,2,Fellow of the Royal Society,915,Contenders,2000,1,2,general,Middle
1989,1980,2,Nobel Prize in Physics,879,Contenders,1982,1,2,physics,Middle
1990,2015,5,Fellow of the Royal Society,707,Contenders,2020,0,5,general,Senior
1991,1982,36,Shanti Swarup Bhatnagar Prize for Science and Technology,1351,Contenders,2018,0,36,general,Young
1992,2002,7,Max Planck Medal,674,Contenders,2009,1,7,physics,Senior
1993,2014,6,Fellow of the Royal Society,204,Contenders,2020,0,6,general,Middle
1994,2003,17,Fellow of the Royal Society,238,Contenders,2020,0,17,general,Middle
1995,1998,18,MacArthur Fellowship,83,Contenders,2016,1,18,general,Young
1996,2016,4,Fellow of the Royal Society,608,Contenders,2020,0,4,general,NA
1997,1998,14,Lasker-DeBakey Clinical Medical Research Award,1003,Contenders,2012,1,14,biology,Senior
1998,2010,5,National Medal of Science,762,Contenders,2015,1,5,general,Senior
1999,1990,27,Fellow of the Royal Society,519,Contenders,2017,1,27,general,NA
2000,1944,65,Nobel Prize in Physics,1285,Contenders,2009,1,65,physics,Middle
2001,1974,46,Shanti Swarup Bhatnagar Prize for Science and Technology,1309,Contenders,2020,0,46,general,Young
2002,1989,18,Turing Award,508,Contenders,2007,1,18,cs,Middle
2003,1983,4,Fellow of the Royal Society,1025,Contenders,1987,1,4,general,Middle
2004,1963,13,Bigsby Medal,1444,Contenders,1976,1,13,geography,Young
2006,1981,32,Fellow of the Royal Society,1401,Contenders,2013,1,32,general,Young
2007,2016,4,Fellow of the Royal Society,773,Contenders,2020,0,4,general,Middle
2008,1996,20,Fellow of the Royal Society,538,Contenders,2016,1,20,general,Middle
2009,2013,7,Lasker-DeBakey Clinical Medical Research Award,1072,Contenders,2020,0,7,biology,Senior
2011,1994,23,Fellow of the Royal Society,377,Contenders,2017,1,23,general,Young
2012,2009,11,Fellow of the Royal Society,1432,Contenders,2020,0,11,general,Middle
2013,2007,13,Shanti Swarup Bhatnagar Prize for Science and Technology,350,Contenders,2020,0,13,general,NA
2014,1977,24,Fellow of the Royal Society,818,Contenders,2001,1,24,general,Young
2015,2002,18,Fellow of the Royal Society,518,Contenders,2020,0,18,general,Middle
2016,1985,1,Nobel Prize in Physics,940,Contenders,1986,1,1,physics,Young
2017,1966,3,Fellow of the Royal Society,790,Contenders,1969,1,3,general,Young
2018,1987,29,Wolf Prize in Physics,172,Contenders,2016,1,29,physics,Middle
2019,2000,10,Turing Award,572,Contenders,2010,1,10,cs,Middle
2021,2001,8,Fellow of the Royal Society,837,Contenders,2009,1,8,general,Middle
2022,2002,18,Shanti Swarup Bhatnagar Prize for Science and Technology,1015,Contenders,2020,0,18,general,Young
2023,2014,6,Nobel Prize in Physiology or Medicine,274,Contenders,2020,0,6,biology,Middle
2024,1993,24,Fellow of the Royal Society,1051,Contenders,2017,1,24,general,Young
2025,2001,9,National Medal of Science,26,Contenders,2010,1,9,general,Senior
2026,1995,23,Wolf Prize in Medicine,311,Contenders,2018,0,23,biology,Middle
2027,2011,7,Nobel Prize in Physiology or Medicine,686,Contenders,2018,0,7,biology,Senior
2028,2007,12,National Medal of Science,965,Contenders,2019,0,12,general,Senior
2029,2011,9,Fellow of the Royal Society,417,Contenders,2020,0,9,general,Middle
2030,1965,55,Nobel Prize in Physiology or Medicine,182,Contenders,2020,0,55,biology,Senior
2031,2014,4,Fellow of the Royal Society,373,Contenders,2018,0,4,general,Young
2032,2010,10,Shanti Swarup Bhatnagar Prize for Science and Technology,791,Contenders,2020,0,10,general,Young
2033,2011,9,Nobel Prize in Physiology or Medicine,1297,Contenders,2020,0,9,biology,Middle
2034,2011,9,Nobel Prize in Physics,454,Contenders,2020,0,9,physics,Middle
2035,1993,26,MacArthur Fellowship,427,Contenders,2019,0,26,general,Middle
2036,1985,10,Shanti Swarup Bhatnagar Prize for Science and Technology,679,Contenders,1995,1,10,general,Young
2037,2014,6,Wolf Prize in Medicine,296,Contenders,2020,0,6,biology,Senior
2038,1997,18,Nobel Prize in Physics,7,Contenders,2015,1,18,physics,Senior
2039,1941,28,Fellow of the Royal Society,1459,Contenders,1969,1,28,general,Young
2040,2006,14,Nobel Prize in Physiology or Medicine,732,Contenders,2020,0,14,biology,Middle
2041,2016,3,MacArthur Fellowship,570,Contenders,2019,0,3,general,Young
2043,2004,0,Shanti Swarup Bhatnagar Prize for Science and Technology,817,Contenders,2004,1,0,general,Young
2044,1974,32,Nobel Prize in Physiology or Medicine,289,Contenders,2006,1,32,biology,Middle
2045,1998,21,MacArthur Fellowship,884,Contenders,2019,0,21,general,Young
2047,1979,37,National Medal of Science,1059,Contenders,2016,1,37,general,Middle
2048,1987,0,MacArthur Fellowship,1367,Contenders,1987,1,0,general,Young
2049,1961,52,Albert Einstein Award,620,Contenders,2013,1,52,physics,Middle
2050,1998,21,Shanti Swarup Bhatnagar Prize for Science and Technology,1148,Contenders,2019,0,21,general,Young
2051,2000,18,Marconi Prize,1206,Contenders,2018,0,18,cs,Middle
2052,2014,5,Fellow of the Royal Society,985,Contenders,2019,0,5,general,Young
2054,2016,4,Wolf Prize in Medicine,978,Contenders,2020,0,4,biology,Senior
2055,1979,41,National Medal of Science,1151,Contenders,2020,0,41,general,Middle
2056,1994,25,Fellow of the Royal Society,376,Contenders,2019,0,25,general,Middle
2057,1992,12,Nobel Prize in Physiology or Medicine,677,Contenders,2004,1,12,biology,Senior
2058,1985,27,Fellow of the Royal Society,1145,Contenders,2012,1,27,general,Middle
2059,2002,18,Fellow of the Royal Society,58,Contenders,2020,0,18,general,Middle
2060,1998,20,Fellow of the Royal Society,474,Contenders,2018,0,20,general,Young
2061,1993,18,MacArthur Fellowship,839,Contenders,2011,1,18,general,Middle
2062,1979,7,Wolf Prize in Medicine,1340,Contenders,1986,1,7,biology,Middle
2063,2010,10,Fields Medal,40,Contenders,2020,0,10,mathematics,Young
2064,1973,44,Nobel Prize in Physics,1107,Contenders,2017,1,44,physics,Middle
2065,1985,34,MacArthur Fellowship,627,Contenders,2019,0,34,general,Young
2066,1997,8,Nobel Prize in Physics,1248,Contenders,2005,1,8,physics,Middle
2067,1971,3,Fellow of the Royal Society,1279,Contenders,1974,1,3,general,Young
2068,1979,37,Shanti Swarup Bhatnagar Prize for Science and Technology,1354,Contenders,2016,1,37,general,Young
2069,1988,18,Fellow of the Royal Society,342,Contenders,2006,1,18,general,Middle
2070,2008,11,Nobel Prize in Chemistry,1154,Contenders,2019,0,11,chemistry,Senior
2071,1990,25,National Medal of Science,1043,Contenders,2015,1,25,general,Middle
2072,2005,14,Fellow of the Royal Society,917,Contenders,2019,0,14,general,Middle
2073,1982,27,Wolf Prize in Medicine,1328,Contenders,2009,1,27,biology,Middle
2074,1982,37,Fellow of the Royal Society,703,Contenders,2019,0,37,general,Middle
2076,1999,20,Fellow of the Royal Society,42,Contenders,2019,0,20,general,Middle
2077,1985,21,Shanti Swarup Bhatnagar Prize for Science and Technology,961,Contenders,2006,1,21,general,Young
2078,2016,4,Fellow of the Royal Society,773,Contenders,2020,0,4,general,Middle
2079,1992,28,Fellow of the Royal Society,1267,Contenders,2020,0,28,general,Middle
2080,2012,8,Fellow of the Royal Society,783,Contenders,2020,0,8,general,Middle
2081,2004,16,Nobel Prize in Physiology or Medicine,332,Contenders,2020,0,16,biology,Middle
2082,2006,14,Fields Medal,948,Contenders,2020,0,14,mathematics,Young
2083,1998,22,Nobel Prize in Physiology or Medicine,1198,Contenders,2020,0,22,biology,Middle
2084,2013,7,Fellow of the Royal Society,1115,Contenders,2020,0,7,general,Middle
2085,1995,1,Wolf Prize in Physics,1113,Contenders,1996,1,1,physics,Senior
2086,2015,5,Breakthrough Prize in Life Sciences,179,Contenders,2020,0,5,biology,Young
2087,2015,5,Fellow of the Royal Society,337,Contenders,2020,0,5,general,Middle
2088,2008,12,MacArthur Fellowship,442,Contenders,2020,0,12,general,NA
2089,2005,14,Fellow of the Royal Society,937,Contenders,2019,0,14,general,NA
2090,1956,60,Fellow of the Royal Society,1342,Contenders,2016,1,60,general,Young
2091,1955,40,Lasker-DeBakey Clinical Medical Research Award,103,Contenders,1995,1,40,biology,Young
2092,1989,6,Shanti Swarup Bhatnagar Prize for Science and Technology,932,Contenders,1995,1,6,general,Young
2093,2016,4,Nobel Prize in Chemistry,185,Contenders,2020,0,4,chemistry,Senior
2094,1965,5,National Medal of Science,1416,Contenders,1970,1,5,general,Young
2095,2007,12,Fellow of the Royal Society,990,Contenders,2019,0,12,general,Middle
2096,1978,39,Nobel Prize in Physiology or Medicine,180,Contenders,2017,1,39,biology,Middle
2097,2002,18,Fellow of the Royal Society,1427,Contenders,2020,0,18,general,Middle
2098,2017,3,Fellow of the Royal Society,1239,Contenders,2020,0,3,general,Middle
2099,2005,12,MacArthur Fellowship,671,Contenders,2017,1,12,general,Young
2100,1981,39,Fellow of the Royal Society,1067,Contenders,2020,0,39,general,Young
2101,2016,4,Fellow of the Royal Society,803,Contenders,2020,0,4,general,NA
2102,2000,20,Shanti Swarup Bhatnagar Prize for Science and Technology,324,Contenders,2020,0,20,general,Young
2103,2006,13,Fields Medal,111,Contenders,2019,0,13,mathematics,Young
2104,2006,13,Fields Medal,483,Contenders,2019,0,13,mathematics,Young
2105,2014,5,Fellow of the Royal Society,410,Contenders,2019,0,5,general,Middle
2106,2016,2,Fellow of the Royal Society,606,Contenders,2018,0,2,general,Middle
2108,1994,23,Fields Medal,138,Contenders,2017,1,23,mathematics,Young
2109,1983,26,Wolf Prize in Chemistry,1352,Contenders,2009,1,26,chemistry,Middle
2110,1992,0,Nobel Prize in Physiology or Medicine,1034,Contenders,1992,1,0,biology,Senior
2111,1993,27,Nobel Prize in Physiology or Medicine,776,Contenders,2020,0,27,biology,Middle
2112,1995,16,MacArthur Fellowship,25,Contenders,2011,1,16,general,Middle
2113,1974,37,Fellow of the Royal Society,1272,Contenders,2011,1,37,general,Middle
2114,1999,21,MacArthur Fellowship,1136,Contenders,2020,0,21,general,Young
2115,2001,18,Shanti Swarup Bhatnagar Prize for Science and Technology,825,Contenders,2019,0,18,general,Young
2116,1951,7,Nobel Prize in Chemistry,893,Contenders,1958,1,7,chemistry,Young
2117,1975,40,National Medal of Science,904,Contenders,2015,1,40,general,Senior
2118,1998,22,MacArthur Fellowship,988,Contenders,2020,0,22,general,Young
2119,2011,9,Fellow of the Royal Society,1180,Contenders,2020,0,9,general,Young
2120,1990,30,Shanti Swarup Bhatnagar Prize for Science and Technology,888,Contenders,2020,0,30,general,Young
2121,1982,36,MacArthur Fellowship,437,Contenders,2018,0,36,general,Young
2122,2009,11,Fellow of the Royal Society,438,Contenders,2020,0,11,general,Middle
2123,2008,4,Nobel Prize in Chemistry,1338,Contenders,2012,1,4,chemistry,Senior
2124,1963,15,Willard Gibbs Award,756,Contenders,1978,1,15,chemistry,Middle
2125,1974,33,National Medal of Science,673,Contenders,2007,1,33,general,Senior
2126,2004,15,MacArthur Fellowship,564,Contenders,2019,0,15,general,Young
2127,1999,17,National Medal of Science,1120,Contenders,2016,1,17,general,Senior
2128,2007,12,MacArthur Fellowship,81,Contenders,2019,0,12,general,Middle
2129,1995,25,National Medal of Science,618,Contenders,2020,0,25,general,Senior
2130,2008,7,Fellow of the Royal Society,725,Contenders,2015,1,7,general,Middle
2131,1979,25,Fellow of the Royal Society,615,Contenders,2004,1,25,general,Young
2132,1999,18,Fellow of the Royal Society,409,Contenders,2017,1,18,general,Middle
2133,2017,3,Fellow of the Royal Society,537,Contenders,2020,0,3,general,Senior
2134,2002,18,Fellow of the Royal Society,546,Contenders,2020,0,18,general,Middle
2135,1987,32,Fellow of the Royal Society,1368,Contenders,2019,0,32,general,Middle
2136,1990,29,Fellow of the Royal Society,778,Contenders,2019,0,29,general,Middle
2137,2016,4,Fellow of the Royal Society,549,Contenders,2020,0,4,general,Senior
2138,1954,25,Nobel Prize in Physiology or Medicine,1430,Contenders,1979,1,25,biology,Young
2139,1984,36,MacArthur Fellowship,1402,Contenders,2020,0,36,general,Young
2140,1993,26,Fellow of the Royal Society,704,Contenders,2019,0,26,general,Middle
2141,2017,3,Fellow of the Royal Society,1194,Contenders,2020,0,3,general,NA
2142,2011,9,National Medal of Science,644,Contenders,2020,0,9,general,Senior
2143,2013,7,Nobel Prize in Physiology or Medicine,86,Contenders,2020,0,7,biology,Middle
2144,1995,8,Fellow of the Royal Society,520,Contenders,2003,1,8,general,Senior
2145,1981,8,MacArthur Fellowship,959,Contenders,1989,1,8,general,Young
2146,1992,8,Shanti Swarup Bhatnagar Prize for Science and Technology,177,Contenders,2000,1,8,general,Young
2147,1999,20,MacArthur Fellowship,719,Contenders,2019,0,20,general,NA
2148,2001,18,Shanti Swarup Bhatnagar Prize for Science and Technology,1304,Contenders,2019,0,18,general,Young
2149,1979,33,Fellow of the Royal Society,1037,Contenders,2012,1,33,general,Young
2150,2002,18,Fellow of the Royal Society,1030,Contenders,2020,0,18,general,Middle
2152,1967,41,Fellow of the Royal Society,1379,Contenders,2008,1,41,general,Young
2153,2018,2,Breakthrough Prize in Mathematics,13,Contenders,2020,0,2,mathematics,Middle
2155,2008,10,Nobel Prize in Physics,1207,Contenders,2018,0,10,physics,Senior
2157,2001,19,Fellow of the Royal Society,443,Contenders,2020,0,19,general,Middle
2158,2004,16,Fellow of the Royal Society,368,Contenders,2020,0,16,general,Middle
2159,1975,43,Nobel Prize in Physiology or Medicine,1396,Contenders,2018,0,43,biology,Young
2160,1985,34,MacArthur Fellowship,912,Contenders,2019,0,34,general,Young
2161,1957,60,Nobel Prize in Physics,689,Contenders,2017,1,60,physics,Young
2162,2012,8,Shanti Swarup Bhatnagar Prize for Science and Technology,1215,Contenders,2020,0,8,general,Young
2163,2016,4,Fellow of the Royal Society,768,Contenders,2020,0,4,general,NA
2164,2000,19,Shanti Swarup Bhatnagar Prize for Science and Technology,386,Contenders,2019,0,19,general,NA
2165,1984,31,MacArthur Fellowship,230,Contenders,2015,1,31,general,Middle
2166,1968,7,Fellow of the Royal Society,1370,Contenders,1975,1,7,general,Young
2168,1991,28,MacArthur Fellowship,202,Contenders,2019,0,28,general,NA
2169,2015,4,Fellow of the Royal Society,363,Contenders,2019,0,4,general,NA
2170,1992,15,MacArthur Fellowship,273,Contenders,2007,1,15,general,Middle
2171,1967,36,Nobel Prize in Chemistry,682,Contenders,2003,1,36,chemistry,Young
2172,1986,17,Wolf Prize in Chemistry,232,Contenders,2003,1,17,chemistry,Senior
2175,2007,12,Hughes Medal,139,Contenders,2019,0,12,physics,Middle
2176,1951,33,Hughes Medal,1324,Contenders,1984,1,33,physics,Middle
2177,2007,11,Fellow of the Royal Society,990,Contenders,2018,0,11,general,Middle
2178,1974,21,Shanti Swarup Bhatnagar Prize for Science and Technology,372,Contenders,1995,1,21,general,Young
2179,1953,50,Fellow of the Royal Society,355,Contenders,2003,1,50,general,Young
2181,2017,3,Fellow of the Royal Society,1233,Contenders,2020,0,3,general,Senior
2182,2015,5,Fellow of the Royal Society,529,Contenders,2020,0,5,general,NA
2183,1984,24,Fellow of the Royal Society,505,Contenders,2008,1,24,general,Young
2184,1987,32,Fellow of the Royal Society,816,Contenders,2019,0,32,general,Young
2185,2007,13,Fellow of the Royal Society,436,Contenders,2020,0,13,general,Senior
2186,1984,26,MacArthur Fellowship,354,Contenders,2010,1,26,general,Young
2187,1942,68,Fellow of the Royal Society,1158,Contenders,2010,1,68,general,Young
2188,2004,15,Shanti Swarup Bhatnagar Prize for Science and Technology,1291,Contenders,2019,0,15,general,Young
2189,2001,19,Fellow of the Royal Society,1144,Contenders,2020,0,19,general,Senior
2190,2018,2,Fellow of the Royal Society,601,Contenders,2020,0,2,general,Middle
2191,2003,17,Shanti Swarup Bhatnagar Prize for Science and Technology,938,Contenders,2020,0,17,general,Young
2192,2011,9,Shanti Swarup Bhatnagar Prize for Science and Technology,781,Contenders,2020,0,9,general,Young
2193,1979,28,Fellow of the Royal Society,991,Contenders,2007,1,28,general,Middle
2194,2006,14,Fellow of the Royal Society,356,Contenders,2020,0,14,general,Middle
2195,2013,7,Fellow of the Royal Society,964,Contenders,2020,0,7,general,Middle
2196,1993,26,Fellow of the Royal Society,143,Contenders,2019,0,26,general,Middle
2197,2008,12,MacArthur Fellowship,9,Contenders,2020,0,12,general,Young
2198,2009,5,National Medal of Science,822,Contenders,2014,1,5,general,Senior
2199,2000,19,Turing Award,572,Contenders,2019,0,19,cs,Middle
2200,2012,7,Fellow of the Royal Society,962,Contenders,2019,0,7,general,Senior
2201,2017,2,Fellow of the Royal Society,1024,Contenders,2019,0,2,general,Middle
2202,1990,24,Nobel Prize in Physics,1412,Contenders,2014,1,24,physics,Middle
2203,1998,22,Fields Medal,466,Contenders,2020,0,22,mathematics,Young
2204,1998,21,Nobel Prize in Physics,952,Contenders,2019,0,21,physics,Middle
2205,2004,12,Fellow of the Royal Society,966,Contenders,2016,1,12,general,Senior
2206,1993,17,Fellow of the Royal Society,704,Contenders,2010,1,17,general,Middle
2207,2001,17,MacArthur Fellowship,170,Contenders,2018,0,17,general,NA
2208,1984,23,Wolf Prize in Medicine,469,Contenders,2007,1,23,biology,Middle
2209,2006,12,Fellow of the Royal Society,1005,Contenders,2018,0,12,general,Middle
2210,2001,18,MacArthur Fellowship,164,Contenders,2019,0,18,general,Young
2211,2010,9,MacArthur Fellowship,1047,Contenders,2019,0,9,general,Young
2212,1983,37,National Medal of Science,109,Contenders,2020,0,37,general,Young
2213,1987,31,Fellow of the Royal Society,621,Contenders,2018,0,31,general,Middle
2214,2009,9,Fellow of the Royal Society,1089,Contenders,2018,0,9,general,Middle
2215,1962,58,Fellow of the Royal Society,1243,Contenders,2020,0,58,general,Middle
2216,1972,24,Fellow of the Royal Society,696,Contenders,1996,1,24,general,Middle
2217,2015,5,MacArthur Fellowship,862,Contenders,2020,0,5,general,NA
2218,2001,8,Nobel Prize in Physics,730,Contenders,2009,1,8,physics,Young
2219,2002,18,Fellow of the Royal Society,440,Contenders,2020,0,18,general,Middle
2220,2008,12,Shanti Swarup Bhatnagar Prize for Science and Technology,623,Contenders,2020,0,12,general,Young
2221,1987,33,Fellow of the Royal Society,1368,Contenders,2020,0,33,general,Middle
2222,1991,29,MacArthur Fellowship,724,Contenders,2020,0,29,general,Young
2225,1978,30,Fellow of the Royal Society,629,Contenders,2008,1,30,general,Young
2226,1978,34,Nobel Prize in Physiology or Medicine,5,Contenders,2012,1,34,biology,Middle
2227,2009,11,Cullum Geographical Medal,846,Contenders,2020,0,11,geography,Senior
2228,2009,11,Fellow of the Royal Society,475,Contenders,2020,0,11,general,NA
2229,1994,2,Shanti Swarup Bhatnagar Prize for Science and Technology,687,Contenders,1996,1,2,general,Young
2230,2001,19,Shanti Swarup Bhatnagar Prize for Science and Technology,825,Contenders,2020,0,19,general,Young
2231,1998,16,Nobel Prize in Physics,1106,Contenders,2014,1,16,physics,Middle
2232,1991,28,Nobel Prize in Physiology or Medicine,161,Contenders,2019,0,28,biology,Middle
2233,2016,3,Fellow of the Royal Society,490,Contenders,2019,0,3,general,Senior
2234,2017,2,Fellow of the Royal Society,1024,Contenders,2019,0,2,general,Middle
2235,1953,55,Nobel Prize in Physiology or Medicine,198,Contenders,2008,1,55,biology,Middle
2236,2010,10,Shanti Swarup Bhatnagar Prize for Science and Technology,265,Contenders,2020,0,10,general,Young
2237,1998,16,MacArthur Fellowship,304,Contenders,2014,1,16,general,NA
2238,2010,5,Fields Medal,920,Contenders,2015,1,5,mathematics,Young
2239,2014,0,Abel Prize,705,Contenders,2014,1,0,mathematics,Senior
2240,2003,17,Fellow of the Royal Society,489,Contenders,2020,0,17,general,Senior
2241,2009,11,MacArthur Fellowship,844,Contenders,2020,0,11,general,Young
2242,2018,2,Fellow of the Royal Society,601,Contenders,2020,0,2,general,Middle
2243,1989,28,National Medal of Science,112,Contenders,2017,1,28,general,Senior
2244,2016,4,Fellow of the Royal Society,490,Contenders,2020,0,4,general,Senior
2245,2015,4,Breakthrough Prize in Life Sciences,34,Contenders,2019,0,4,biology,Middle
2246,2014,5,Fellow of the Royal Society,1036,Contenders,2019,0,5,general,NA
2247,2008,8,Wolf Prize in Medicine,16,Contenders,2016,1,8,biology,Senior
2248,2013,7,Shanti Swarup Bhatnagar Prize for Science and Technology,761,Contenders,2020,0,7,general,NA
2249,1998,22,Wolf Prize in Medicine,292,Contenders,2020,0,22,biology,Senior
2250,2002,18,Wolf Prize in Medicine,1,Contenders,2020,0,18,biology,Senior
2251,2009,11,Shanti Swarup Bhatnagar Prize for Science and Technology,1449,Contenders,2020,0,11,general,NA
2252,1983,26,Wolf Prize in Physics,796,Contenders,2009,1,26,physics,Senior
2253,2015,2,Fellow of the Royal Society,901,Contenders,2017,1,2,general,Middle
2254,1992,20,National Medal of Science,212,Contenders,2012,1,20,general,Senior
2255,1999,21,National Medal of Science,1120,Contenders,2020,0,21,general,Senior
2256,1993,12,Fellow of the Royal Society,996,Contenders,2005,1,12,general,Young
2257,1966,6,Fellow of the Royal Society,500,Contenders,1972,1,6,general,Middle
2258,2007,13,Fellow of the Royal Society,1446,Contenders,2020,0,13,general,Middle
2259,1989,29,Shanti Swarup Bhatnagar Prize for Science and Technology,1112,Contenders,2018,0,29,general,NA
2260,2011,9,Shanti Swarup Bhatnagar Prize for Science and Technology,781,Contenders,2020,0,9,general,Young
2261,2001,19,Fellow of the Royal Society,1288,Contenders,2020,0,19,general,Middle
2262,2008,12,Shanti Swarup Bhatnagar Prize for Science and Technology,567,Contenders,2020,0,12,general,Young
2263,1984,25,Nobel Prize in Chemistry,573,Contenders,2009,1,25,chemistry,Senior
2264,2018,2,Fellow of the Royal Society,1095,Contenders,2020,0,2,general,NA
2265,1977,40,Fellow of the Royal Society,331,Contenders,2017,1,40,general,Middle
2266,1972,30,Lasker-DeBakey Clinical Medical Research Award,199,Contenders,2002,1,30,biology,Middle
2267,1999,20,MacArthur Fellowship,1429,Contenders,2019,0,20,general,Young
2268,2008,12,National Medal of Science,916,Contenders,2020,0,12,general,Senior
2270,2017,3,Nobel Prize in Physiology or Medicine,1442,Contenders,2020,0,3,biology,Senior
2271,2017,2,Fellow of the Royal Society,715,Contenders,2019,0,2,general,NA
2272,2016,4,Fellow of the Royal Society,768,Contenders,2020,0,4,general,NA
2273,1977,42,Fellow of the Royal Society,478,Contenders,2019,0,42,general,Young
2274,1982,10,MacArthur Fellowship,857,Contenders,1992,1,10,general,Middle
2275,2000,18,Nobel Prize in Chemistry,637,Contenders,2018,0,18,chemistry,Senior
2276,1994,4,Willard Gibbs Award,325,Contenders,1998,1,4,chemistry,Senior
2277,2008,1,Turing Award,566,Contenders,2009,1,1,cs,Senior
2278,2011,9,National Medal of Science,534,Contenders,2020,0,9,general,Senior
2279,2001,19,Max Planck Medal,918,Contenders,2020,0,19,physics,Middle
2280,2006,7,Turing Award,631,Contenders,2013,1,7,cs,Senior
2281,2014,5,Fields Medal,983,Contenders,2019,0,5,mathematics,Young
2282,2008,11,Fellow of the Royal Society,725,Contenders,2019,0,11,general,Middle
2283,2016,4,Breakthrough Prize in Life Sciences,405,Contenders,2020,0,4,biology,Young
2284,2015,4,Nobel Prize in Chemistry,123,Contenders,2019,0,4,chemistry,Senior
2285,2015,4,Wolf Prize in Medicine,463,Contenders,2019,0,4,biology,Senior
2286,1995,17,MacArthur Fellowship,25,Contenders,2012,1,17,general,Middle
2287,1985,35,MacArthur Fellowship,627,Contenders,2020,0,35,general,Young
2288,1993,16,Wollaston Medal,795,Contenders,2009,1,16,geography,Senior
2289,1985,24,Fellow of the Royal Society,692,Contenders,2009,1,24,general,Young
2290,2012,8,Fellow of the Royal Society,371,Contenders,2020,0,8,general,Young
2291,2005,15,Fellow of the Royal Society,334,Contenders,2020,0,15,general,Middle
2292,1979,9,Fellow of the Royal Society,1099,Contenders,1988,1,9,general,Middle
2293,2010,10,MacArthur Fellowship,1313,Contenders,2020,0,10,general,Young
2294,1998,21,Nobel Prize in Physiology or Medicine,1198,Contenders,2019,0,21,biology,Middle
2296,2007,12,MacArthur Fellowship,675,Contenders,2019,0,12,general,NA
2297,2009,11,MacArthur Fellowship,1437,Contenders,2020,0,11,general,Young
2298,1997,12,MacArthur Fellowship,792,Contenders,2009,1,12,general,Young
2299,2013,7,Fellow of the Royal Society,939,Contenders,2020,0,7,general,NA
2300,2011,7,Marconi Prize,646,Contenders,2018,0,7,cs,Senior
2301,1990,10,Lyell Medal,1331,Contenders,2000,1,10,geography,Middle
2302,2002,18,Wolf Prize in Medicine,56,Contenders,2020,0,18,biology,Senior
2303,2013,6,Shanti Swarup Bhatnagar Prize for Science and Technology,540,Contenders,2019,0,6,general,Young
2304,2005,15,National Medal of Science,1039,Contenders,2020,0,15,general,Middle
2305,2015,2,MacArthur Fellowship,507,Contenders,2017,1,2,general,Young
2306,1978,37,Shanti Swarup Bhatnagar Prize for Science and Technology,797,Contenders,2015,1,37,general,Young
2307,2016,4,Fellow of the Royal Society,1012,Contenders,2020,0,4,general,NA
2308,1990,30,Shanti Swarup Bhatnagar Prize for Science and Technology,449,Contenders,2020,0,30,general,Young
2309,2016,4,SASTRA Ramanujan Prize,50,Contenders,2020,0,4,mathematics,Young
2310,2007,12,SASTRA Ramanujan Prize,1123,Contenders,2019,0,12,mathematics,Young
2311,2008,8,Wolf Prize in Medicine,815,Contenders,2016,1,8,biology,Senior
2312,2013,7,Breakthrough Prize in Life Sciences,176,Contenders,2020,0,7,biology,Senior
2313,2006,12,Wolf Prize in Chemistry,79,Contenders,2018,0,12,chemistry,Senior
2314,1995,25,Marconi Prize,246,Contenders,2020,0,25,cs,Senior
2315,2014,6,Fellow of the Royal Society,53,Contenders,2020,0,6,general,Middle
2316,2017,3,Fellow of the Royal Society,769,Contenders,2020,0,3,general,NA
2317,1985,14,Fellow of the Royal Society,849,Contenders,1999,1,14,general,Middle
2318,1998,18,Lasker-DeBakey Clinical Medical Research Award,209,Contenders,2016,1,18,biology,Senior
2319,1990,26,MacArthur Fellowship,1199,Contenders,2016,1,26,general,Young
2320,2006,8,Nobel Prize in Physics,329,Contenders,2014,1,8,physics,Senior
2321,1992,16,Shanti Swarup Bhatnagar Prize for Science and Technology,1050,Contenders,2008,1,16,general,Young
2322,2016,4,Wolf Prize in Chemistry,1426,Contenders,2020,0,4,chemistry,Middle
2323,2000,19,Nobel Prize in Physics,630,Contenders,2019,0,19,physics,Senior
2324,2006,14,Nobel Prize in Chemistry,60,Contenders,2020,0,14,chemistry,Middle
2325,2013,6,Shanti Swarup Bhatnagar Prize for Science and Technology,540,Contenders,2019,0,6,general,Young
2326,2009,11,Willard Gibbs Award,981,Contenders,2020,0,11,chemistry,Senior
2327,2004,15,Shanti Swarup Bhatnagar Prize for Science and Technology,956,Contenders,2019,0,15,general,Young
2328,2013,6,Fellow of the Royal Society,964,Contenders,2019,0,6,general,Middle
2329,1999,15,MacArthur Fellowship,1429,Contenders,2014,1,15,general,Young
2330,1992,13,MacArthur Fellowship,273,Contenders,2005,1,13,general,Middle
2331,2005,14,Max Planck Medal,328,Contenders,2019,0,14,physics,Middle
2332,1989,22,Fellow of the Royal Society,1414,Contenders,2011,1,22,general,Senior
2333,2008,12,Nobel Prize in Chemistry,1154,Contenders,2020,0,12,chemistry,Senior
2334,1995,24,Shanti Swarup Bhatnagar Prize for Science and Technology,1182,Contenders,2019,0,24,general,Young
2335,2007,12,MacArthur Fellowship,81,Contenders,2019,0,12,general,Middle
2336,2010,9,Shanti Swarup Bhatnagar Prize for Science and Technology,594,Contenders,2019,0,9,general,Young
2337,2016,4,Breakthrough Prize in Life Sciences,405,Contenders,2020,0,4,biology,Young
2338,2018,2,Breakthrough Prize in Life Sciences,624,Contenders,2020,0,2,biology,Middle
2340,2005,9,Fellow of the Royal Society,346,Contenders,2014,1,9,general,Middle
2341,2008,12,MacArthur Fellowship,9,Contenders,2020,0,12,general,Young
2342,2015,4,Fellow of the Royal Society,12,Contenders,2019,0,4,general,Senior
2343,2012,8,Fellow of the Royal Society,747,Contenders,2020,0,8,general,Middle
2344,2005,15,Nobel Prize in Physics,1278,Contenders,2020,0,15,physics,Senior
2345,2013,7,Fellow of the Royal Society,999,Contenders,2020,0,7,general,Middle
2346,2015,5,Fellow of the Royal Society,43,Contenders,2020,0,5,general,Middle
2347,1954,28,Fellow of the Royal Society,880,Contenders,1982,1,28,general,Young
2348,2001,16,Shanti Swarup Bhatnagar Prize for Science and Technology,1304,Contenders,2017,1,16,general,Young
2349,2006,14,Nobel Prize in Physiology or Medicine,732,Contenders,2020,0,14,biology,Middle
2350,1994,12,Nobel Prize in Chemistry,1462,Contenders,2006,1,12,chemistry,Senior
2351,1991,4,Shanti Swarup Bhatnagar Prize for Science and Technology,993,Contenders,1995,1,4,general,Young
2352,2002,9,Shanti Swarup Bhatnagar Prize for Science and Technology,1023,Contenders,2011,1,9,general,Young
2353,2001,18,MacArthur Fellowship,170,Contenders,2019,0,18,general,NA
2354,1967,5,Fellow of the Royal Society,642,Contenders,1972,1,5,general,Senior
2355,2000,20,Fellow of the Royal Society,726,Contenders,2020,0,20,general,Young
2356,1998,15,Shanti Swarup Bhatnagar Prize for Science and Technology,812,Contenders,2013,1,15,general,Young
2357,1974,11,Lasker-DeBakey Clinical Medical Research Award,1336,Contenders,1985,1,11,biology,Senior
2358,1987,33,Fellow of the Royal Society,763,Contenders,2020,0,33,general,Senior
2359,1988,21,Nobel Prize in Chemistry,433,Contenders,2009,1,21,chemistry,Young
2360,1986,33,Fields Medal,1142,Contenders,2019,0,33,mathematics,Young
2361,2013,7,MacArthur Fellowship,49,Contenders,2020,0,7,general,Young
2362,2009,11,Fellow of the Royal Society,821,Contenders,2020,0,11,general,Middle
2363,1992,14,Fellow of the Royal Society,267,Contenders,2006,1,14,general,Young
2364,2006,12,Fellow of the Royal Society,1431,Contenders,2018,0,12,general,NA
2365,2005,14,Shanti Swarup Bhatnagar Prize for Science and Technology,456,Contenders,2019,0,14,general,Young
2366,2009,5,Nobel Prize in Physiology or Medicine,231,Contenders,2014,1,5,biology,Middle
2367,1983,36,Fellow of the Royal Society,542,Contenders,2019,0,36,general,Middle
2368,1991,29,Shanti Swarup Bhatnagar Prize for Science and Technology,993,Contenders,2020,0,29,general,Young
2369,1990,19,Wolf Prize in Physics,93,Contenders,2009,1,19,physics,Middle
2370,2017,3,Fellow of the Royal Society,1024,Contenders,2020,0,3,general,Middle
2371,1990,19,Wolf Prize in Medicine,709,Contenders,2009,1,19,biology,Senior
2372,2008,9,National Medal of Science,858,Contenders,2017,1,9,general,Senior
2373,1992,27,MacArthur Fellowship,165,Contenders,2019,0,27,general,Senior
2374,1984,10,Shanti Swarup Bhatnagar Prize for Science and Technology,445,Contenders,1994,1,10,general,Young
2375,1983,30,National Medal of Science,943,Contenders,2013,1,30,general,Young
2376,1964,4,Nobel Prize in Physiology or Medicine,1424,Contenders,1968,1,4,biology,Middle
2377,1951,55,Albert Einstein Award,655,Contenders,2006,1,55,physics,Young
2378,2016,4,Fellow of the Royal Society,930,Contenders,2020,0,4,general,Middle
2379,1987,32,Fellow of the Royal Society,382,Contenders,2019,0,32,general,Middle
2380,1992,28,Fellow of the Royal Society,1070,Contenders,2020,0,28,general,Senior
2381,1990,30,Shanti Swarup Bhatnagar Prize for Science and Technology,926,Contenders,2020,0,30,general,Young
2382,2002,17,Fellow of the Royal Society,225,Contenders,2019,0,17,general,Middle
2383,2001,17,Fellow of the Royal Society,1385,Contenders,2018,0,17,general,Middle
2384,1986,22,Fellow of the Royal Society,414,Contenders,2008,1,22,general,Young
2385,2015,4,Fellow of the Royal Society,875,Contenders,2019,0,4,general,Middle
2386,1972,8,Davy Medal,306,Contenders,1980,1,8,chemistry,Middle
2387,1994,26,Fellow of the Royal Society,664,Contenders,2020,0,26,general,Young
2388,2004,16,Fellow of the Royal Society,1209,Contenders,2020,0,16,general,Middle
2389,1990,11,Nobel Prize in Physiology or Medicine,1229,Contenders,2001,1,11,biology,Senior
2390,2003,17,National Medal of Science,203,Contenders,2020,0,17,general,Senior
2391,2005,14,Fellow of the Royal Society,452,Contenders,2019,0,14,general,Senior
2392,1979,41,National Medal of Science,1059,Contenders,2020,0,41,general,Middle
2393,1974,19,National Medal of Science,673,Contenders,1993,1,19,general,Senior
2394,2013,7,MacArthur Fellowship,1277,Contenders,2020,0,7,general,Young
2395,1984,8,Shanti Swarup Bhatnagar Prize for Science and Technology,1292,Contenders,1992,1,8,general,Young
2396,2001,18,Nobel Prize in Chemistry,21,Contenders,2019,0,18,chemistry,Senior
2397,2005,14,Willard Gibbs Award,1035,Contenders,2019,0,14,chemistry,Senior
2398,1958,22,Nobel Prize in Physiology or Medicine,392,Contenders,1980,1,22,biology,Middle
2399,2012,8,Wolf Prize in Physics,1269,Contenders,2020,0,8,physics,Senior
2400,2011,5,Nobel Prize in Physiology or Medicine,686,Contenders,2016,1,5,biology,Senior
2402,2017,3,Nobel Prize in Physiology or Medicine,1088,Contenders,2020,0,3,biology,Senior
2403,2002,17,Shanti Swarup Bhatnagar Prize for Science and Technology,527,Contenders,2019,0,17,general,Young
2404,1998,21,Fellow of the Royal Society,474,Contenders,2019,0,21,general,Young
2405,2012,8,Nobel Prize in Chemistry,167,Contenders,2020,0,8,chemistry,Middle
2406,2011,9,Wolf Prize in Medicine,784,Contenders,2020,0,9,biology,Middle
2407,1996,20,Fellow of the Royal Society,850,Contenders,2016,1,20,general,Middle
2408,1973,33,Nobel Prize in Physics,1107,Contenders,2006,1,33,physics,Middle
2409,2017,2,Fellow of the Royal Society,237,Contenders,2019,0,2,general,NA
2410,1986,34,Fellow of the Royal Society,414,Contenders,2020,0,34,general,Young
2411,2013,3,MacArthur Fellowship,49,Contenders,2016,1,3,general,Young
2412,2013,7,Breakthrough Prize in Life Sciences,176,Contenders,2020,0,7,biology,Senior
2413,2016,3,Fellow of the Royal Society,772,Contenders,2019,0,3,general,Young
2414,1983,25,MacArthur Fellowship,885,Contenders,2008,1,25,general,Young
2415,1991,17,National Medal of Science,1372,Contenders,2008,1,17,general,Middle
2416,2000,14,MacArthur Fellowship,61,Contenders,2014,1,14,general,Young
2417,1992,27,National Medal of Science,384,Contenders,2019,0,27,general,Senior
2419,1975,35,National Medal of Science,491,Contenders,2010,1,35,general,Senior
2420,1991,18,Fellow of the Royal Society,510,Contenders,2009,1,18,general,Senior
2421,1981,37,Nobel Prize in Physics,577,Contenders,2018,0,37,physics,Senior
2422,1989,29,Willard Gibbs Award,899,Contenders,2018,0,29,chemistry,Senior
2423,1945,61,Copley Medal,388,Contenders,2006,1,61,general,Senior
2424,1991,28,MacArthur Fellowship,202,Contenders,2019,0,28,general,NA
2425,2000,20,Fellow of the Royal Society,720,Contenders,2020,0,20,general,NA
2426,1989,29,Fellow of the Royal Society,420,Contenders,2018,0,29,general,Young
2427,1998,16,National Medal of Science,434,Contenders,2014,1,16,general,Senior
2428,2004,16,Fellow of the Royal Society,1219,Contenders,2020,0,16,general,Middle
2429,2015,5,Fellow of the Royal Society,12,Contenders,2020,0,5,general,Senior
2430,2003,16,Shanti Swarup Bhatnagar Prize for Science and Technology,1162,Contenders,2019,0,16,general,Young
2431,2010,10,Fellow of the Royal Society,691,Contenders,2020,0,10,general,Middle
2432,2003,17,MacArthur Fellowship,753,Contenders,2020,0,17,general,Young
2433,1982,37,Shanti Swarup Bhatnagar Prize for Science and Technology,578,Contenders,2019,0,37,general,Young
2434,1999,19,National Medal of Science,1120,Contenders,2018,0,19,general,Senior
2435,2003,17,MacArthur Fellowship,8,Contenders,2020,0,17,general,Young
2436,2014,6,Breakthrough Prize in Life Sciences,85,Contenders,2020,0,6,biology,Senior
2437,2002,18,Fellow of the Royal Society,1221,Contenders,2020,0,18,general,Middle
2438,1990,29,Shanti Swarup Bhatnagar Prize for Science and Technology,449,Contenders,2019,0,29,general,Young
2439,2016,4,Fellow of the Royal Society,1076,Contenders,2020,0,4,general,Senior
2440,2016,4,Fellow of the Royal Society,906,Contenders,2020,0,4,general,Middle
2441,1988,0,Nobel Prize in Chemistry,823,Contenders,1988,1,0,chemistry,Young
2442,1984,26,MacArthur Fellowship,354,Contenders,2010,1,26,general,Young
2443,2005,15,Shanti Swarup Bhatnagar Prize for Science and Technology,113,Contenders,2020,0,15,general,Young
2444,1997,16,Fellow of the Royal Society,1006,Contenders,2013,1,16,general,Middle
2445,2002,11,Wolf Prize in Medicine,1,Contenders,2013,1,11,biology,Senior
2446,1983,16,Fellow of the Royal Society,1025,Contenders,1999,1,16,general,Middle
2447,1988,6,Nobel Prize in Chemistry,433,Contenders,1994,1,6,chemistry,Young
2448,1998,22,Fellow of the Royal Society,735,Contenders,2020,0,22,general,Young
2449,2016,4,Fellow of the Royal Society,528,Contenders,2020,0,4,general,NA
2450,1991,17,Fellow of the Royal Society,980,Contenders,2008,1,17,general,Young
2451,2001,19,Nobel Prize in Physics,323,Contenders,2020,0,19,physics,Middle
2452,1968,38,Fellow of the Royal Society,1339,Contenders,2006,1,38,general,Young
2453,2000,19,Nobel Prize in Physics,799,Contenders,2019,0,19,physics,Senior
2454,1964,1,National Medal of Science,701,Contenders,1965,1,1,general,Middle
2455,2016,3,Shanti Swarup Bhatnagar Prize for Science and Technology,389,Contenders,2019,0,3,general,Young
2456,1983,29,Fellow of the Royal Society,525,Contenders,2012,1,29,general,Middle
2457,2016,4,Fellow of the Royal Society,906,Contenders,2020,0,4,general,Middle
2458,2009,11,Shanti Swarup Bhatnagar Prize for Science and Technology,175,Contenders,2020,0,11,general,Young
2459,2005,10,Vautrin Lud Prize,1009,Contenders,2015,1,10,geography,Senior
2460,1995,24,Fellow of the Royal Society,1257,Contenders,2019,0,24,general,Young
2461,1994,26,Fellow of the Royal Society,1064,Contenders,2020,0,26,general,Young
2462,2015,5,Fellow of the Royal Society,43,Contenders,2020,0,5,general,Middle
2463,1992,27,Fellow of the Royal Society,571,Contenders,2019,0,27,general,Middle
2464,1987,17,MacArthur Fellowship,1133,Contenders,2004,1,17,general,Middle
2465,2006,8,Fellow of the Royal Society,855,Contenders,2014,1,8,general,Middle
2466,2000,18,National Medal of Science,171,Contenders,2018,0,18,general,Senior
2467,2015,5,Nobel Prize in Physics,1356,Contenders,2020,0,5,physics,Middle
2468,1923,35,Fellow of the Royal Society,580,Contenders,1958,1,35,general,Young
2469,2001,17,National Medal of Science,26,Contenders,2018,0,17,general,Senior
2470,2012,8,Wolf Prize in Mathematics,124,Contenders,2020,0,8,mathematics,Senior
2471,2001,18,National Medal of Science,263,Contenders,2019,0,18,general,Senior
2472,1986,27,National Medal of Science,396,Contenders,2013,1,27,general,Young
2473,1987,26,Nobel Prize in Physiology or Medicine,36,Contenders,2013,1,26,biology,Middle
2474,2013,6,Fellow of the Royal Society,999,Contenders,2019,0,6,general,Middle
2475,2014,6,Wolf Prize in Mathematics,459,Contenders,2020,0,6,mathematics,Senior
2476,2010,10,Shanti Swarup Bhatnagar Prize for Science and Technology,594,Contenders,2020,0,10,general,Young
2477,1992,14,Fellow of the Royal Society,1046,Contenders,2006,1,14,general,Middle
2478,2008,11,Hughes Medal,1415,Contenders,2019,0,11,physics,Middle
2479,2017,2,Fellow of the Royal Society,660,Contenders,2019,0,2,general,Middle
2480,2014,6,Fellow of the Royal Society,204,Contenders,2020,0,6,general,Middle
2481,1987,21,Nobel Prize in Physics,1084,Contenders,2008,1,21,physics,Young
2482,2014,6,Fellow of the Royal Society,94,Contenders,2020,0,6,general,Middle
2483,1999,16,Fellow of the Royal Society,133,Contenders,2015,1,16,general,Senior
2484,2017,0,Fellow of the Royal Society,1233,Contenders,2017,1,0,general,Senior
2485,2001,19,Fellow of the Royal Society,1302,Contenders,2020,0,19,general,Middle
2486,2009,10,Fellow of the Royal Society,1138,Contenders,2019,0,10,general,NA
2487,2017,3,Wollaston Medal,907,Contenders,2020,0,3,geography,Middle
2488,2011,9,National Medal of Science,683,Contenders,2020,0,9,general,Senior
2489,2000,15,National Medal of Science,641,Contenders,2015,1,15,general,Senior
2490,2014,6,Fellow of the Royal Society,94,Contenders,2020,0,6,general,Middle
2491,1987,12,Fellow of the Royal Society,553,Contenders,1999,1,12,general,Middle
2492,2003,7,National Medal of Science,1164,Contenders,2010,1,7,general,Senior
2493,2003,11,Fellow of the Royal Society,489,Contenders,2014,1,11,general,Senior
2494,2013,6,Nobel Prize in Physiology or Medicine,1103,Contenders,2019,0,6,biology,Senior
2495,2003,3,Shanti Swarup Bhatnagar Prize for Science and Technology,1162,Contenders,2006,1,3,general,Young
2496,1985,22,Willard Gibbs Award,154,Contenders,2007,1,22,chemistry,Senior
2497,1999,20,MacArthur Fellowship,517,Contenders,2019,0,20,general,Young
2498,2005,13,Fellow of the Royal Society,1069,Contenders,2018,0,13,general,Middle
2499,2006,0,National Medal of Science,1420,Contenders,2006,1,0,general,Senior
2500,1990,16,Fellow of the Royal Society,778,Contenders,2006,1,16,general,Middle
2501,1996,23,Fellow of the Royal Society,229,Contenders,2019,0,23,general,Young
2502,2017,3,Breakthrough Prize in Life Sciences,68,Contenders,2020,0,3,biology,Senior
2503,2010,10,MacArthur Fellowship,1313,Contenders,2020,0,10,general,Young
2504,2003,12,Shanti Swarup Bhatnagar Prize for Science and Technology,1000,Contenders,2015,1,12,general,Young
2505,1998,21,Wolf Prize in Medicine,292,Contenders,2019,0,21,biology,Senior
2507,2004,16,Fellow of the Royal Society,477,Contenders,2020,0,16,general,Middle
2508,1987,29,Fellow of the Royal Society,657,Contenders,2016,1,29,general,Senior
2509,1987,25,Fellow of the Royal Society,183,Contenders,2012,1,25,general,Middle
2510,1989,31,Fellow of the Royal Society,1414,Contenders,2020,0,31,general,Senior
2511,1975,9,National Medal of Science,904,Contenders,1984,1,9,general,Senior
2512,2002,18,Fellow of the Royal Society,546,Contenders,2020,0,18,general,Middle
2513,2013,7,Fellow of the Royal Society,336,Contenders,2020,0,7,general,Middle
2514,2014,5,Abel Prize,705,Contenders,2019,0,5,mathematics,Senior
2515,2010,10,Fellow of the Royal Society,1062,Contenders,2020,0,10,general,Middle
2516,2015,1,MacArthur Fellowship,507,Contenders,2016,1,1,general,Young
2518,2016,4,Fellow of the Royal Society,430,Contenders,2020,0,4,general,NA
2519,2003,17,MacArthur Fellowship,106,Contenders,2020,0,17,general,Young
2520,2010,10,Shanti Swarup Bhatnagar Prize for Science and Technology,955,Contenders,2020,0,10,general,NA
2521,2010,10,Fellow of the Royal Society,1062,Contenders,2020,0,10,general,Middle
2522,1995,19,MacArthur Fellowship,925,Contenders,2014,1,19,general,Middle
2523,2005,15,Wolf Prize in Physics,218,Contenders,2020,0,15,physics,Senior
2524,2005,15,Fellow of the Royal Society,1405,Contenders,2020,0,15,general,Middle
2525,1944,29,Fellow of the Royal Society,669,Contenders,1973,1,29,general,Middle
2526,2000,20,Fellow of the Royal Society,294,Contenders,2020,0,20,general,Middle
2527,2010,10,National Medal of Science,281,Contenders,2020,0,10,general,Senior
2528,1980,35,Wolf Prize in Physics,765,Contenders,2015,1,35,physics,Young
2529,1993,27,Max Planck Medal,400,Contenders,2020,0,27,physics,Middle
2530,2006,14,Shanti Swarup Bhatnagar Prize for Science and Technology,30,Contenders,2020,0,14,general,Young
2531,2002,17,Fellow of the Royal Society,1030,Contenders,2019,0,17,general,Middle
2532,2005,15,Wolf Prize in Physics,218,Contenders,2020,0,15,physics,Senior
2533,2003,17,Lasker-DeBakey Clinical Medical Research Award,604,Contenders,2020,0,17,biology,Senior
2534,2013,6,National Medal of Science,541,Contenders,2019,0,6,general,Middle
2535,1988,1,Fellow of the Royal Society,1395,Contenders,1989,1,1,general,Young
2537,2014,6,Nobel Prize in Physiology or Medicine,1045,Contenders,2020,0,6,biology,Middle
2539,1998,22,Fellow of the Royal Society,735,Contenders,2020,0,22,general,Young
2540,2016,4,Wolf Prize in Chemistry,1426,Contenders,2020,0,4,chemistry,Middle
2542,1993,23,Fellow of the Royal Society,143,Contenders,2016,1,23,general,Middle
2543,2013,7,Fellow of the Royal Society,999,Contenders,2020,0,7,general,Middle
2544,2013,7,Nobel Prize in Physiology or Medicine,284,Contenders,2020,0,7,biology,Senior
2545,2006,6,National Medal of Science,1044,Contenders,2012,1,6,general,Senior
2546,1988,5,Shanti Swarup Bhatnagar Prize for Science and Technology,922,Contenders,1993,1,5,general,Young
2547,1975,33,Nobel Prize in Physiology or Medicine,1396,Contenders,2008,1,33,biology,Young
2548,2011,9,Fellow of the Royal Society,1407,Contenders,2020,0,9,general,Senior
2549,2008,12,Shanti Swarup Bhatnagar Prize for Science and Technology,623,Contenders,2020,0,12,general,Young
2550,1965,8,Nobel Prize in Physiology or Medicine,182,Contenders,1973,1,8,biology,Senior
2551,1995,23,Wolf Prize in Medicine,311,Contenders,2018,0,23,biology,Middle
2552,2008,12,Fellow of the Royal Society,163,Contenders,2020,0,12,general,NA
2553,2015,4,MacArthur Fellowship,862,Contenders,2019,0,4,general,NA
2554,2018,2,Fellow of the Royal Society,1387,Contenders,2020,0,2,general,Middle
2555,1987,4,MacArthur Fellowship,1289,Contenders,1991,1,4,general,Young
2556,1988,30,National Medal of Science,552,Contenders,2018,0,30,general,Senior
2557,1972,2,Shanti Swarup Bhatnagar Prize for Science and Technology,958,Contenders,1974,1,2,general,Young
2558,1991,6,National Medal of Science,1440,Contenders,1997,1,6,general,Senior
2559,2007,10,Turing Award,722,Contenders,2017,1,10,cs,Middle
2560,1993,25,Fellow of the Royal Society,933,Contenders,2018,0,25,general,Middle
2561,1994,22,Fellow of the Royal Society,1064,Contenders,2016,1,22,general,Young
2562,2001,15,MacArthur Fellowship,164,Contenders,2016,1,15,general,Young
2563,2015,5,Fellow of the Royal Society,1097,Contenders,2020,0,5,general,NA
2564,1994,18,Willard Gibbs Award,325,Contenders,2012,1,18,chemistry,Senior
2565,2000,12,National Medal of Science,641,Contenders,2012,1,12,general,Senior
2566,1990,30,National Medal of Science,494,Contenders,2020,0,30,general,Middle
2567,1983,36,MacArthur Fellowship,117,Contenders,2019,0,36,general,Young
2568,1974,27,Fields Medal,362,Contenders,2001,1,27,mathematics,Young
2569,2014,5,Wolf Prize in Medicine,296,Contenders,2019,0,5,biology,Senior
2570,2003,12,National Medal of Science,1164,Contenders,2015,1,12,general,Senior
2571,1939,25,Fellow of the Royal Society,1187,Contenders,1964,1,25,general,Young
2572,1984,10,Fellow of the Royal Society,1122,Contenders,1994,1,10,general,Middle
2573,1996,24,Fellow of the Royal Society,335,Contenders,2020,0,24,general,Middle
2574,2006,14,MacArthur Fellowship,385,Contenders,2020,0,14,general,Young
2575,1987,33,Fellow of the Royal Society,763,Contenders,2020,0,33,general,Senior
2576,1998,15,Fellow of the Royal Society,735,Contenders,2013,1,15,general,Young
2577,1995,24,Fellow of the Royal Society,121,Contenders,2019,0,24,general,Middle
2578,2017,2,Fellow of the Royal Society,1042,Contenders,2019,0,2,general,NA
2579,2009,11,Cullum Geographical Medal,846,Contenders,2020,0,11,geography,Senior
2580,1997,18,Fellow of the Royal Society,975,Contenders,2015,1,18,general,Young
2581,2009,10,Nobel Prize in Physiology or Medicine,345,Contenders,2019,0,10,biology,Middle
2582,2001,19,Nobel Prize in Physics,69,Contenders,2020,0,19,physics,Young
2583,2015,4,Nobel Prize in Physics,1301,Contenders,2019,0,4,physics,Senior
2584,1964,4,Nobel Prize in Physics,379,Contenders,1968,1,4,physics,Young
2585,1981,35,MacArthur Fellowship,148,Contenders,2016,1,35,general,Middle
2586,1995,24,Wolf Prize in Medicine,311,Contenders,2019,0,24,biology,Middle
2587,2009,10,National Medal of Science,173,Contenders,2019,0,10,general,Senior
2588,2009,7,MacArthur Fellowship,485,Contenders,2016,1,7,general,Middle
2589,2015,5,MacArthur Fellowship,972,Contenders,2020,0,5,general,NA
2590,2005,15,Fellow of the Royal Society,937,Contenders,2020,0,15,general,NA
2591,2015,5,Fellow of the Royal Society,264,Contenders,2020,0,5,general,Senior
2592,1962,49,Fellow of the Royal Society,1105,Contenders,2011,1,49,general,Young
2593,1976,15,Fellow of the Royal Society,1298,Contenders,1991,1,15,general,Middle
2594,2008,10,Nobel Prize in Chemistry,1154,Contenders,2018,0,10,chemistry,Senior
2595,2014,6,Fields Medal,102,Contenders,2020,0,6,mathematics,Young
2596,1974,46,Shanti Swarup Bhatnagar Prize for Science and Technology,1299,Contenders,2020,0,46,general,Young
2597,2000,20,Nobel Prize in Chemistry,579,Contenders,2020,0,20,chemistry,Senior
2598,2010,10,Nobel Prize in Chemistry,1286,Contenders,2020,0,10,chemistry,Senior
2599,1983,32,Shanti Swarup Bhatnagar Prize for Science and Technology,716,Contenders,2015,1,32,general,Young
2600,2013,7,Fellow of the Royal Society,59,Contenders,2020,0,7,general,Senior
2601,1987,10,MacArthur Fellowship,275,Contenders,1997,1,10,general,Senior
2602,1994,20,Nobel Prize in Chemistry,1462,Contenders,2014,1,20,chemistry,Senior
2603,2000,20,Shanti Swarup Bhatnagar Prize for Science and Technology,386,Contenders,2020,0,20,general,NA
2604,2014,6,Fellow of the Royal Society,985,Contenders,2020,0,6,general,Young
2605,1997,9,MacArthur Fellowship,1439,Contenders,2006,1,9,general,Young
2606,2002,14,Nobel Prize in Physiology or Medicine,119,Contenders,2016,1,14,biology,Middle
2607,1999,20,Shanti Swarup Bhatnagar Prize for Science and Technology,302,Contenders,2019,0,20,general,Young
2608,1993,27,Shanti Swarup Bhatnagar Prize for Science and Technology,1242,Contenders,2020,0,27,general,Young
2609,2012,8,Nobel Prize in Physics,1078,Contenders,2020,0,8,physics,Senior
2610,2016,3,Fellow of the Royal Society,137,Contenders,2019,0,3,general,NA
2611,1994,26,Fields Medal,340,Contenders,2020,0,26,mathematics,Young
2612,2006,13,Fellow of the Royal Society,1060,Contenders,2019,0,13,general,Senior
2613,2002,17,Shanti Swarup Bhatnagar Prize for Science and Technology,734,Contenders,2019,0,17,general,Middle
2614,1977,9,Fellow of the Royal Society,331,Contenders,1986,1,9,general,Middle
2615,1976,43,National Medal of Science,1177,Contenders,2019,0,43,general,Senior
2616,1976,26,Fellow of the Royal Society,1065,Contenders,2002,1,26,general,Middle
2618,1998,22,Nobel Prize in Physics,1106,Contenders,2020,0,22,physics,Middle
2619,1994,26,Turing Award,931,Contenders,2020,0,26,cs,Middle
2620,2015,5,Wolf Prize in Medicine,186,Contenders,2020,0,5,biology,Senior
2621,1982,30,MacArthur Fellowship,437,Contenders,2012,1,30,general,Young
2622,1985,11,Fellow of the Royal Society,828,Contenders,1996,1,11,general,Senior
2623,2005,15,Lyell Medal,208,Contenders,2020,0,15,geography,Middle
2624,2015,5,Fellow of the Royal Society,455,Contenders,2020,0,5,general,NA
2625,2003,16,Fellow of the Royal Society,503,Contenders,2019,0,16,general,Senior
2626,1962,53,Fellow of the Royal Society,1105,Contenders,2015,1,53,general,Young
2627,1972,37,Shanti Swarup Bhatnagar Prize for Science and Technology,798,Contenders,2009,1,37,general,Young
2628,2014,6,National Medal of Science,1256,Contenders,2020,0,6,general,Senior
2629,2010,10,Fields Medal,543,Contenders,2020,0,10,mathematics,Young
2630,2017,1,Fellow of the Royal Society,556,Contenders,2018,0,1,general,Senior
2631,2013,7,MacArthur Fellowship,64,Contenders,2020,0,7,general,Middle
2632,1982,38,Shanti Swarup Bhatnagar Prize for Science and Technology,845,Contenders,2020,0,38,general,Young
2633,1984,26,Shanti Swarup Bhatnagar Prize for Science and Technology,445,Contenders,2010,1,26,general,Young
2634,1993,27,MacArthur Fellowship,427,Contenders,2020,0,27,general,Middle
2635,2014,6,Nobel Prize in Physics,1280,Contenders,2020,0,6,physics,Middle
2636,1974,32,Lasker-DeBakey Clinical Medical Research Award,1336,Contenders,2006,1,32,biology,Senior
2637,2016,4,MacArthur Fellowship,570,Contenders,2020,0,4,general,Young
2638,1983,26,Shanti Swarup Bhatnagar Prize for Science and Technology,562,Contenders,2009,1,26,general,Young
2639,2011,8,National Medal of Science,534,Contenders,2019,0,8,general,Senior
2640,2013,7,MacArthur Fellowship,1277,Contenders,2020,0,7,general,Young
2641,1995,4,MacArthur Fellowship,925,Contenders,1999,1,4,general,Middle
2642,2010,10,MacArthur Fellowship,1421,Contenders,2020,0,10,general,Young
2643,2016,4,Breakthrough Prize in Life Sciences,66,Contenders,2020,0,4,biology,Senior
2644,2012,5,Wolf Prize in Mathematics,262,Contenders,2017,1,5,mathematics,Senior
2645,2018,2,Bigsby Medal,672,Contenders,2020,0,2,geography,NA
2646,1993,27,Shanti Swarup Bhatnagar Prize for Science and Technology,640,Contenders,2020,0,27,general,Young
2647,1992,27,MacArthur Fellowship,908,Contenders,2019,0,27,general,Middle
2648,2011,8,Fellow of the Royal Society,509,Contenders,2019,0,8,general,Middle
2649,2011,9,Nobel Prize in Physiology or Medicine,1297,Contenders,2020,0,9,biology,Middle
2650,2009,11,MacArthur Fellowship,1437,Contenders,2020,0,11,general,Young
2651,1972,48,Fellow of the Royal Society,976,Contenders,2020,0,48,general,Middle
2652,2017,3,Fellow of the Royal Society,71,Contenders,2020,0,3,general,Middle
2653,2015,4,Fellow of the Royal Society,330,Contenders,2019,0,4,general,Middle
2654,1973,21,Nobel Prize in Physics,1107,Contenders,1994,1,21,physics,Middle
2655,2008,11,Nobel Prize in Physiology or Medicine,24,Contenders,2019,0,11,biology,Senior
2656,2004,16,Nobel Prize in Physiology or Medicine,406,Contenders,2020,0,16,biology,Middle
2657,1996,19,Shanti Swarup Bhatnagar Prize for Science and Technology,239,Contenders,2015,1,19,general,Young
2658,2002,18,Shanti Swarup Bhatnagar Prize for Science and Technology,843,Contenders,2020,0,18,general,Young
2659,1979,41,Fellow of the Royal Society,1099,Contenders,2020,0,41,general,Middle
2660,2001,19,Fellow of the Royal Society,1237,Contenders,2020,0,19,general,Young
2661,1995,23,Fellow of the Royal Society,236,Contenders,2018,0,23,general,Middle
2662,1997,22,MacArthur Fellowship,1439,Contenders,2019,0,22,general,Young
2663,1998,22,Shanti Swarup Bhatnagar Prize for Science and Technology,889,Contenders,2020,0,22,general,Young
2664,2000,18,MacArthur Fellowship,351,Contenders,2018,0,18,general,NA
2665,2015,5,Claude E. Shannon Award,1147,Contenders,2020,0,5,cs,Senior
2666,2016,4,Fellow of the Royal Society,490,Contenders,2020,0,4,general,Senior
2667,1978,39,Fellow of the Royal Society,1411,Contenders,2017,1,39,general,Young
2668,1982,31,Willard Gibbs Award,1422,Contenders,2013,1,31,chemistry,Senior
2669,2010,1,Shanti Swarup Bhatnagar Prize for Science and Technology,116,Contenders,2011,1,1,general,Young
2670,1982,28,Wolf Prize in Medicine,1328,Contenders,2010,1,28,biology,Middle
2671,1993,11,Wollaston Medal,795,Contenders,2004,1,11,geography,Senior
2672,1982,21,MacArthur Fellowship,1384,Contenders,2003,1,21,general,Young
2673,1993,22,Fellow of the Royal Society,996,Contenders,2015,1,22,general,Young
2674,2016,4,Fellow of the Royal Society,317,Contenders,2020,0,4,general,Senior
2675,2017,2,Wolf Prize in Physics,632,Contenders,2019,0,2,physics,Senior
2676,1988,32,Wolf Prize in Chemistry,836,Contenders,2020,0,32,chemistry,Middle
2677,2011,9,Shanti Swarup Bhatnagar Prize for Science and Technology,260,Contenders,2020,0,9,general,Young
2678,2016,4,Lasker-DeBakey Clinical Medical Research Award,193,Contenders,2020,0,4,biology,Middle
2679,2004,16,Nobel Prize in Physiology or Medicine,406,Contenders,2020,0,16,biology,Middle
2680,2002,18,Fellow of the Royal Society,225,Contenders,2020,0,18,general,Middle
2683,1984,29,Fellow of the Royal Society,505,Contenders,2013,1,29,general,Young
2684,2000,20,MacArthur Fellowship,741,Contenders,2020,0,20,general,Young
2685,2016,2,SASTRA Ramanujan Prize,50,Contenders,2018,0,2,mathematics,Young
2686,2015,5,Wolf Prize in Physics,298,Contenders,2020,0,5,physics,Senior
2687,2008,6,Nobel Prize in Physics,1203,Contenders,2014,1,6,physics,Senior
2688,1999,21,Fellow of the Royal Society,805,Contenders,2020,0,21,general,Middle
2689,2005,15,Lyell Medal,208,Contenders,2020,0,15,geography,Middle
2690,2017,0,Fellow of the Royal Society,963,Contenders,2017,1,0,general,Senior
2691,1990,28,National Medal of Science,591,Contenders,2018,0,28,general,Senior
2692,1955,17,Nobel Prize in Chemistry,82,Contenders,1972,1,17,chemistry,Middle
2693,1992,18,MacArthur Fellowship,134,Contenders,2010,1,18,general,Middle
2694,1986,27,Fellow of the Royal Society,343,Contenders,2013,1,27,general,Senior
2695,2001,12,Wolf Prize in Mathematics,919,Contenders,2013,1,12,mathematics,Senior
2696,2006,14,Wolf Prize in Chemistry,79,Contenders,2020,0,14,chemistry,Senior
2697,2012,8,Shanti Swarup Bhatnagar Prize for Science and Technology,954,Contenders,2020,0,8,general,Young
2698,2001,19,Fellow of the Royal Society,443,Contenders,2020,0,19,general,Middle
2699,2000,10,Fellow of the Royal Society,270,Contenders,2010,1,10,general,Senior
2700,1987,32,MacArthur Fellowship,1322,Contenders,2019,0,32,general,Young
2701,2003,17,MacArthur Fellowship,753,Contenders,2020,0,17,general,Young
2702,1959,32,Shanti Swarup Bhatnagar Prize for Science and Technology,814,Contenders,1991,1,32,general,Young
2703,2009,9,Shanti Swarup Bhatnagar Prize for Science and Technology,175,Contenders,2018,0,9,general,Young
2704,2011,6,MacArthur Fellowship,771,Contenders,2017,1,6,general,Young
2705,2001,11,Shanti Swarup Bhatnagar Prize for Science and Technology,285,Contenders,2012,1,11,general,Young
2706,2006,14,Nobel Prize in Physiology or Medicine,142,Contenders,2020,0,14,biology,Middle
2707,1997,21,MacArthur Fellowship,1156,Contenders,2018,0,21,general,Young
2708,1947,63,Nobel Prize in Physiology or Medicine,261,Contenders,2010,1,63,biology,Middle
2709,1920,76,Nobel Prize in Physiology or Medicine,934,Contenders,1996,1,76,biology,Middle
2710,2014,6,Shanti Swarup Bhatnagar Prize for Science and Technology,944,Contenders,2020,0,6,general,Young
2711,1989,31,Fellow of the Royal Society,1061,Contenders,2020,0,31,general,Middle
2712,2014,6,National Medal of Science,1256,Contenders,2020,0,6,general,Senior
2713,1983,0,National Medal of Science,283,Contenders,1983,1,0,general,Senior
2714,2014,2,Fields Medal,983,Contenders,2016,1,2,mathematics,Young
2715,1992,24,Shanti Swarup Bhatnagar Prize for Science and Technology,1050,Contenders,2016,1,24,general,Young
2716,1995,22,Shanti Swarup Bhatnagar Prize for Science and Technology,979,Contenders,2017,1,22,general,Young
2717,1993,5,MacArthur Fellowship,839,Contenders,1998,1,5,general,Middle
2718,1978,38,Turing Award,423,Contenders,2016,1,38,cs,Young
2719,1984,19,Nobel Prize in Physics,666,Contenders,2003,1,19,physics,Middle
2720,1990,13,Nobel Prize in Physics,1380,Contenders,2003,1,13,physics,Senior
2721,2014,6,Fellow of the Royal Society,41,Contenders,2020,0,6,general,Middle
2722,1992,25,Fellow of the Royal Society,710,Contenders,2017,1,25,general,Middle
2723,2013,3,MacArthur Fellowship,49,Contenders,2016,1,3,general,Young
2724,2016,4,Fellow of the Royal Society,971,Contenders,2020,0,4,general,Middle
2725,2009,11,Wollaston Medal,1296,Contenders,2020,0,11,geography,Senior
2726,2006,14,Nobel Prize in Physics,329,Contenders,2020,0,14,physics,Senior
2727,1985,34,Fellow of the Royal Society,692,Contenders,2019,0,34,general,Young
2728,2003,17,Fellow of the Royal Society,1129,Contenders,2020,0,17,general,Middle
2729,2011,9,MacArthur Fellowship,786,Contenders,2020,0,9,general,Young
2730,1996,21,Fellow of the Royal Society,1193,Contenders,2017,1,21,general,Senior
2731,1967,42,Nobel Prize in Physiology or Medicine,1300,Contenders,2009,1,42,biology,Senior
2732,2008,11,Fellow of the Royal Society,149,Contenders,2019,0,11,general,NA
2733,2009,11,Fellow of the Royal Society,1138,Contenders,2020,0,11,general,NA
2734,2016,3,Fellow of the Royal Society,532,Contenders,2019,0,3,general,Young
2735,1992,26,National Medal of Science,854,Contenders,2018,0,26,general,Senior
2736,2015,5,Breakthrough Prize in Life Sciences,34,Contenders,2020,0,5,biology,Middle
2737,2009,10,National Medal of Science,173,Contenders,2019,0,10,general,Senior
2738,2007,13,National Medal of Science,861,Contenders,2020,0,13,general,Senior
2739,1982,2,Shanti Swarup Bhatnagar Prize for Science and Technology,845,Contenders,1984,1,2,general,Young
2740,1997,23,Shanti Swarup Bhatnagar Prize for Science and Technology,341,Contenders,2020,0,23,general,Young
2741,1994,26,Wolf Prize in Chemistry,894,Contenders,2020,0,26,chemistry,Young
2742,1976,14,Turing Award,1409,Contenders,1990,1,14,cs,Young
2743,1993,26,Wolf Prize in Mathematics,401,Contenders,2019,0,26,mathematics,Middle
2744,1998,20,Lasker-DeBakey Clinical Medical Research Award,1003,Contenders,2018,0,20,biology,Senior
2745,2017,0,Fellow of the Royal Society,897,Contenders,2017,1,0,general,Middle
2746,2016,4,Shanti Swarup Bhatnagar Prize for Science and Technology,736,Contenders,2020,0,4,general,Young
2747,2012,8,Max Planck Medal,1150,Contenders,2020,0,8,physics,Middle
2748,2017,2,Fellow of the Royal Society,1173,Contenders,2019,0,2,general,Senior
2749,1894,43,Fellow of the Royal Society,174,Contenders,1937,1,43,general,Young
2750,2001,18,Shanti Swarup Bhatnagar Prize for Science and Technology,285,Contenders,2019,0,18,general,Young
2751,1975,25,Fellow of the Royal Society,1217,Contenders,2000,1,25,general,Senior
2752,1985,13,Fellow of the Royal Society,1406,Contenders,1998,1,13,general,Young
2753,2008,11,Fellow of the Royal Society,352,Contenders,2019,0,11,general,Young
2754,2006,12,Fellow of the Royal Society,1431,Contenders,2018,0,12,general,NA
2755,2012,7,National Medal of Science,97,Contenders,2019,0,7,general,Senior
2756,1997,23,Fellow of the Royal Society,611,Contenders,2020,0,23,general,Middle
2757,2016,3,Shanti Swarup Bhatnagar Prize for Science and Technology,603,Contenders,2019,0,3,general,NA
2758,1970,19,Fields Medal,779,Contenders,1989,1,19,mathematics,Young
2759,1973,19,National Medal of Science,1179,Contenders,1992,1,19,general,Middle
2760,2007,13,MacArthur Fellowship,675,Contenders,2020,0,13,general,NA
2762,1995,22,Wolf Prize in Physics,1113,Contenders,2017,1,22,physics,Senior
2763,2000,19,MacArthur Fellowship,1273,Contenders,2019,0,19,general,Young
2764,1973,3,Nobel Prize in Physics,215,Contenders,1976,1,3,physics,Young
2765,2010,7,National Medal of Science,762,Contenders,2017,1,7,general,Senior
2766,2001,18,Nobel Prize in Physiology or Medicine,742,Contenders,2019,0,18,biology,Middle
2767,1990,16,Turing Award,498,Contenders,2006,1,16,cs,Senior
2768,2001,13,Wolf Prize in Chemistry,1222,Contenders,2014,1,13,chemistry,Senior
2769,2015,5,Fellow of the Royal Society,766,Contenders,2020,0,5,general,NA
2770,1970,29,Max Planck Medal,942,Contenders,1999,1,29,physics,Middle
2771,2008,11,Nobel Prize in Physics,1207,Contenders,2019,0,11,physics,Senior
2772,2007,11,Fellow of the Royal Society,206,Contenders,2018,0,11,general,Young
2773,1986,33,MacArthur Fellowship,973,Contenders,2019,0,33,general,Middle
2774,2001,1,Fellow of the Royal Society,1385,Contenders,2002,1,1,general,Middle
2775,1966,8,Shanti Swarup Bhatnagar Prize for Science and Technology,713,Contenders,1974,1,8,general,Young
2776,1989,30,MacArthur Fellowship,802,Contenders,2019,0,30,general,Young
2777,1979,40,Fellow of the Royal Society,1099,Contenders,2019,0,40,general,Middle
2778,2008,11,Nobel Prize in Chemistry,1338,Contenders,2019,0,11,chemistry,Senior
2779,1958,61,Fellow of the Royal Society,1399,Contenders,2019,0,61,general,Young
2780,1995,25,MacArthur Fellowship,129,Contenders,2020,0,25,general,Young
2781,2013,6,Fellow of the Royal Society,512,Contenders,2019,0,6,general,Senior
2782,2014,6,Nobel Prize in Physics,921,Contenders,2020,0,6,physics,Middle
2783,1997,21,MacArthur Fellowship,698,Contenders,2018,0,21,general,Young
2784,2013,7,Nobel Prize in Physiology or Medicine,1103,Contenders,2020,0,7,biology,Senior
2785,1979,41,Nobel Prize in Physics,1458,Contenders,2020,0,41,physics,Middle
2787,1991,24,MacArthur Fellowship,626,Contenders,2015,1,24,general,Senior
2788,1994,23,Shanti Swarup Bhatnagar Prize for Science and Technology,1071,Contenders,2017,1,23,general,Young
2789,1944,45,Fellow of the Royal Society,1146,Contenders,1989,1,45,general,Young
2790,1997,23,MacArthur Fellowship,1439,Contenders,2020,0,23,general,Young
2791,1995,20,Fellow of the Royal Society,1433,Contenders,2015,1,20,general,Middle
2792,2001,14,MacArthur Fellowship,690,Contenders,2015,1,14,general,Middle
2793,2017,3,Fellow of the Royal Society,660,Contenders,2020,0,3,general,Middle
2794,2018,0,Breakthrough Prize in Mathematics,13,Contenders,2018,0,0,mathematics,Middle
2795,1990,30,Shanti Swarup Bhatnagar Prize for Science and Technology,1373,Contenders,2020,0,30,general,Young
2796,2016,4,Shanti Swarup Bhatnagar Prize for Science and Technology,808,Contenders,2020,0,4,general,Young
2797,1992,27,National Medal of Science,384,Contenders,2019,0,27,general,Senior
2798,1999,21,Fellow of the Royal Society,852,Contenders,2020,0,21,general,Middle
2799,2006,14,Fellow of the Royal Society,11,Contenders,2020,0,14,general,Middle
2800,1947,39,Fellow of the Royal Society,495,Contenders,1986,1,39,general,Middle
2801,2012,6,Abel Prize,877,Contenders,2018,0,6,mathematics,Senior
2802,2016,4,Lasker-DeBakey Clinical Medical Research Award,193,Contenders,2020,0,4,biology,Middle
2803,1982,38,Shanti Swarup Bhatnagar Prize for Science and Technology,578,Contenders,2020,0,38,general,Young
2804,1986,17,Fellow of the Royal Society,1027,Contenders,2003,1,17,general,Middle
2805,1979,27,National Medal of Science,1378,Contenders,2006,1,27,general,Senior
2806,1982,34,MacArthur Fellowship,1330,Contenders,2016,1,34,general,Young
2807,2015,5,Fellow of the Royal Society,707,Contenders,2020,0,5,general,Senior
2808,1937,28,Hughes Medal,1183,Contenders,1965,1,28,physics,Young
2809,1939,8,Fellow of the Royal Society,1187,Contenders,1947,1,8,general,Young
2810,2006,14,Nobel Prize in Physiology or Medicine,732,Contenders,2020,0,14,biology,Middle
2811,2000,20,Fellow of the Royal Society,787,Contenders,2020,0,20,general,Middle
2812,1997,22,Shanti Swarup Bhatnagar Prize for Science and Technology,241,Contenders,2019,0,22,general,Young
2813,2012,8,Shanti Swarup Bhatnagar Prize for Science and Technology,954,Contenders,2020,0,8,general,Young
2814,2014,6,Shanti Swarup Bhatnagar Prize for Science and Technology,1098,Contenders,2020,0,6,general,Young
2815,1984,36,MacArthur Fellowship,1383,Contenders,2020,0,36,general,Young
2816,1999,20,MacArthur Fellowship,1429,Contenders,2019,0,20,general,Young
2817,1987,32,Fellow of the Royal Society,553,Contenders,2019,0,32,general,Middle
2818,2008,11,Shanti Swarup Bhatnagar Prize for Science and Technology,181,Contenders,2019,0,11,general,Young
2819,1987,30,Nobel Prize in Physics,1084,Contenders,2017,1,30,physics,Young
2820,2004,16,Fellow of the Royal Society,619,Contenders,2020,0,16,general,Middle
2821,2003,17,Shanti Swarup Bhatnagar Prize for Science and Technology,1000,Contenders,2020,0,17,general,Young
2822,1988,29,Fellow of the Royal Society,342,Contenders,2017,1,29,general,Middle
2823,2009,11,Fellow of the Royal Society,457,Contenders,2020,0,11,general,Middle
2824,2017,2,Fellow of the Royal Society,890,Contenders,2019,0,2,general,NA
2825,1997,19,Fellow of the Royal Society,118,Contenders,2016,1,19,general,Middle
2826,2005,15,Shanti Swarup Bhatnagar Prize for Science and Technology,113,Contenders,2020,0,15,general,Young
2827,2007,10,Fellow of the Royal Society,990,Contenders,2017,1,10,general,Middle
2828,2011,3,Shanti Swarup Bhatnagar Prize for Science and Technology,781,Contenders,2014,1,3,general,Young
2829,1980,39,Nobel Prize in Chemistry,1178,Contenders,2019,0,39,chemistry,Middle
2830,1986,34,Shanti Swarup Bhatnagar Prize for Science and Technology,522,Contenders,2020,0,34,general,NA
2831,1992,27,MacArthur Fellowship,165,Contenders,2019,0,27,general,Senior
2832,2015,4,Fellow of the Royal Society,718,Contenders,2019,0,4,general,Senior
2833,1996,15,Lasker-DeBakey Clinical Medical Research Award,994,Contenders,2011,1,15,biology,Senior
2834,2004,15,Fellow of the Royal Society,192,Contenders,2019,0,15,general,Young
2835,2018,1,Breakthrough Prize in Life Sciences,72,Contenders,2019,0,1,biology,Senior
2836,1987,10,Fellow of the Royal Society,657,Contenders,1997,1,10,general,Senior
2837,1994,9,Wollaston Medal,780,Contenders,2003,1,9,geography,Middle
2838,1989,23,Willard Gibbs Award,899,Contenders,2012,1,23,chemistry,Senior
2839,2015,1,Shanti Swarup Bhatnagar Prize for Science and Technology,305,Contenders,2016,1,1,general,Young
2840,2018,2,Bigsby Medal,672,Contenders,2020,0,2,geography,NA
2841,2010,9,Wolf Prize in Physics,214,Contenders,2019,0,9,physics,Senior
2842,2005,15,Fellow of the Royal Society,1083,Contenders,2020,0,15,general,Middle
2843,1990,27,Fellow of the Royal Society,758,Contenders,2017,1,27,general,Young
2845,1995,25,Fellow of the Royal Society,1433,Contenders,2020,0,25,general,Middle
2846,2009,11,Nobel Prize in Chemistry,44,Contenders,2020,0,11,chemistry,Senior
2847,1979,34,Fellow of the Royal Society,1216,Contenders,2013,1,34,general,Young
2848,1997,23,MacArthur Fellowship,792,Contenders,2020,0,23,general,Young
2849,1955,52,Nobel Prize in Chemistry,82,Contenders,2007,1,52,chemistry,Middle
2850,2001,17,National Medal of Science,263,Contenders,2018,0,17,general,Senior
2851,1963,17,Lyell Medal,1227,Contenders,1980,1,17,geography,Middle
2852,1984,21,Fellow of the Royal Society,583,Contenders,2005,1,21,general,Middle
2854,2008,11,Shanti Swarup Bhatnagar Prize for Science and Technology,848,Contenders,2019,0,11,general,NA
2855,1973,20,Fellow of the Royal Society,1109,Contenders,1993,1,20,general,Young
2857,1998,21,Fellow of the Royal Society,465,Contenders,2019,0,21,general,Middle
2858,1997,22,MacArthur Fellowship,600,Contenders,2019,0,22,general,Young
2859,1989,31,Shanti Swarup Bhatnagar Prize for Science and Technology,1316,Contenders,2020,0,31,general,Young
2860,2009,11,Fellow of the Royal Society,1089,Contenders,2020,0,11,general,Middle
2861,2003,17,MacArthur Fellowship,8,Contenders,2020,0,17,general,Young
2862,1963,48,Willard Gibbs Award,756,Contenders,2011,1,48,chemistry,Middle
2863,1989,3,Shanti Swarup Bhatnagar Prize for Science and Technology,1316,Contenders,1992,1,3,general,Young
2864,1987,31,MacArthur Fellowship,1289,Contenders,2018,0,31,general,Young
2865,2016,4,Fellow of the Royal Society,317,Contenders,2020,0,4,general,Senior
2866,2004,16,Fellow of the Royal Society,619,Contenders,2020,0,16,general,Middle
2867,1999,21,Fellow of the Royal Society,805,Contenders,2020,0,21,general,Middle
2868,2009,10,Shanti Swarup Bhatnagar Prize for Science and Technology,813,Contenders,2019,0,10,general,Young
2869,1948,16,Fellow of the Royal Society,240,Contenders,1964,1,16,general,Middle
2870,1987,19,Shanti Swarup Bhatnagar Prize for Science and Technology,1029,Contenders,2006,1,19,general,Young
2871,1963,40,Lasker-DeBakey Clinical Medical Research Award,152,Contenders,2003,1,40,biology,Middle
2872,2007,13,Lasker-DeBakey Clinical Medical Research Award,800,Contenders,2020,0,13,biology,Senior
2874,1994,19,Fellow of the Royal Society,52,Contenders,2013,1,19,general,Middle
2875,2011,9,MacArthur Fellowship,651,Contenders,2020,0,9,general,Young
2876,1982,37,MacArthur Fellowship,728,Contenders,2019,0,37,general,Young
2877,1997,22,Nobel Prize in Physics,1248,Contenders,2019,0,22,physics,Middle
2878,1983,21,Shanti Swarup Bhatnagar Prize for Science and Technology,562,Contenders,2004,1,21,general,Young
2879,2016,4,Fellow of the Royal Society,430,Contenders,2020,0,4,general,NA
2880,1976,3,Marconi Prize,1031,Contenders,1979,1,3,cs,Middle
2881,2009,11,Fellow of the Royal Society,457,Contenders,2020,0,11,general,Middle
2882,2017,1,Fellow of the Royal Society,1101,Contenders,2018,0,1,general,Senior
2883,1960,54,Fellow of the Royal Society,559,Contenders,2014,1,54,general,Young
2884,1985,29,Nobel Prize in Chemistry,1170,Contenders,2014,1,29,chemistry,Senior
2885,2002,16,MacArthur Fellowship,481,Contenders,2018,0,16,general,Young
2886,2006,14,Fields Medal,111,Contenders,2020,0,14,mathematics,Young
2887,2005,14,Fellow of the Royal Society,656,Contenders,2019,0,14,general,Middle
2888,1978,35,Nobel Prize in Physics,1361,Contenders,2013,1,35,physics,Young
2889,2011,9,Wolf Prize in Medicine,784,Contenders,2020,0,9,biology,Middle
2890,2005,14,Shanti Swarup Bhatnagar Prize for Science and Technology,668,Contenders,2019,0,14,general,NA
2891,2017,3,Fellow of the Royal Society,555,Contenders,2020,0,3,general,NA
2892,1984,19,Fellow of the Royal Society,1122,Contenders,2003,1,19,general,Middle
2893,2014,6,Shanti Swarup Bhatnagar Prize for Science and Technology,944,Contenders,2020,0,6,general,Young
2894,2000,20,Fellow of the Royal Society,294,Contenders,2020,0,20,general,Middle
2895,2012,8,Nobel Prize in Chemistry,167,Contenders,2020,0,8,chemistry,Middle
2896,2017,3,Nobel Prize in Physiology or Medicine,1442,Contenders,2020,0,3,biology,Senior
2897,2010,9,Shanti Swarup Bhatnagar Prize for Science and Technology,955,Contenders,2019,0,9,general,NA
2898,2013,7,National Medal of Science,541,Contenders,2020,0,7,general,Middle
2899,1998,12,Shanti Swarup Bhatnagar Prize for Science and Technology,812,Contenders,2010,1,12,general,Young
2900,1978,36,Shanti Swarup Bhatnagar Prize for Science and Technology,521,Contenders,2014,1,36,general,Young
2901,2009,11,Fellow of the Royal Society,1138,Contenders,2020,0,11,general,NA
2902,2002,4,Shanti Swarup Bhatnagar Prize for Science and Technology,869,Contenders,2006,1,4,general,Young
2903,2006,13,Nobel Prize in Physics,329,Contenders,2019,0,13,physics,Senior
2904,2018,1,Fellow of the Royal Society,1387,Contenders,2019,0,1,general,Middle
2905,2017,3,Fellow of the Royal Society,576,Contenders,2020,0,3,general,NA
2906,1993,25,MacArthur Fellowship,427,Contenders,2018,0,25,general,Middle
2907,1980,36,Fellow of the Royal Society,1447,Contenders,2016,1,36,general,Middle
2908,2007,13,Fellow of the Royal Society,1446,Contenders,2020,0,13,general,Middle
2909,2004,5,Shanti Swarup Bhatnagar Prize for Science and Technology,446,Contenders,2009,1,5,general,Young
2910,2004,4,Fellow of the Royal Society,368,Contenders,2008,1,4,general,Middle
2911,2008,12,Shanti Swarup Bhatnagar Prize for Science and Technology,848,Contenders,2020,0,12,general,NA
2912,1983,35,Shanti Swarup Bhatnagar Prize for Science and Technology,562,Contenders,2018,0,35,general,Young
2913,1982,38,Fellow of the Royal Society,1149,Contenders,2020,0,38,general,Young
2914,1994,26,Fellow of the Royal Society,1168,Contenders,2020,0,26,general,Middle
2915,2002,18,Shanti Swarup Bhatnagar Prize for Science and Technology,527,Contenders,2020,0,18,general,Young
2916,1998,7,National Medal of Science,434,Contenders,2005,1,7,general,Senior
2917,1995,21,Fellow of the Royal Society,1274,Contenders,2016,1,21,general,Middle
2918,1990,1,Nobel Prize in Physiology or Medicine,1229,Contenders,1991,1,1,biology,Senior
2919,2015,4,SASTRA Ramanujan Prize,15,Contenders,2019,0,4,mathematics,Young
2920,2007,13,National Medal of Science,861,Contenders,2020,0,13,general,Senior
2921,1991,26,Shanti Swarup Bhatnagar Prize for Science and Technology,697,Contenders,2017,1,26,general,Young
2922,1981,3,Fellow of the Royal Society,1345,Contenders,1984,1,3,general,Middle
2923,1982,26,Shanti Swarup Bhatnagar Prize for Science and Technology,578,Contenders,2008,1,26,general,Young
2924,2006,14,Fields Medal,483,Contenders,2020,0,14,mathematics,Young
2926,1967,52,Albert Einstein Award,824,Contenders,2019,0,52,physics,Young
2927,1986,33,Nobel Prize in Chemistry,402,Contenders,2019,0,33,chemistry,Middle
2928,2008,5,Wolf Prize in Medicine,815,Contenders,2013,1,5,biology,Senior
2929,2016,3,Fellow of the Royal Society,1012,Contenders,2019,0,3,general,NA
2930,2006,13,Fellow of the Royal Society,356,Contenders,2019,0,13,general,Middle
2931,1993,25,MacArthur Fellowship,84,Contenders,2018,0,25,general,Middle
2932,2009,11,Lasker-DeBakey Clinical Medical Research Award,168,Contenders,2020,0,11,biology,Middle
2933,1988,32,MacArthur Fellowship,865,Contenders,2020,0,32,general,Young
2934,1980,40,Fellow of the Royal Society,1447,Contenders,2020,0,40,general,Middle
2935,1997,2,Nobel Prize in Physics,903,Contenders,1999,1,2,physics,Middle
2936,1995,25,Fellow of the Royal Society,1274,Contenders,2020,0,25,general,Middle
2937,2013,7,Fellow of the Royal Society,939,Contenders,2020,0,7,general,NA
2938,2005,15,Fellow of the Royal Society,1079,Contenders,2020,0,15,general,Senior
2939,2017,3,Fellow of the Royal Society,660,Contenders,2020,0,3,general,Middle
2940,2015,5,Fellow of the Royal Society,1293,Contenders,2020,0,5,general,Senior
2941,1998,19,Fellow of the Royal Society,1314,Contenders,2017,1,19,general,Senior
2942,2015,4,Wolf Prize in Medicine,463,Contenders,2019,0,4,biology,Senior
2943,2004,16,MacArthur Fellowship,564,Contenders,2020,0,16,general,Young
2944,2006,13,Fellow of the Royal Society,1358,Contenders,2019,0,13,general,Senior
2945,2017,2,Max Planck Medal,1052,Contenders,2019,0,2,physics,Senior
2946,2006,14,Fellow of the Royal Society,1167,Contenders,2020,0,14,general,Middle
2947,2012,8,National Medal of Science,97,Contenders,2020,0,8,general,Senior
2948,2003,16,Lasker-DeBakey Clinical Medical Research Award,587,Contenders,2019,0,16,biology,Middle
2949,1984,19,Fellow of the Royal Society,1122,Contenders,2003,1,19,general,Middle
2950,1989,29,Fellow of the Royal Society,348,Contenders,2018,0,29,general,Young
2951,2002,15,Fellow of the Royal Society,141,Contenders,2017,1,15,general,Senior
2952,2000,15,MacArthur Fellowship,153,Contenders,2015,1,15,general,Middle
2953,2007,13,Fellow of the Royal Society,206,Contenders,2020,0,13,general,Young
2954,1985,20,Fellow of the Royal Society,1145,Contenders,2005,1,20,general,Middle
2955,1981,15,Shanti Swarup Bhatnagar Prize for Science and Technology,708,Contenders,1996,1,15,general,Young
2956,1963,5,Nobel Prize in Chemistry,1026,Contenders,1968,1,5,chemistry,Senior
2957,2013,5,Fellow of the Royal Society,1326,Contenders,2018,0,5,general,Middle
2958,1996,14,Shanti Swarup Bhatnagar Prize for Science and Technology,239,Contenders,2010,1,14,general,Young
2959,1975,6,Nobel Prize in Physics,1235,Contenders,1981,1,6,physics,Middle
2960,2008,12,Hughes Medal,1415,Contenders,2020,0,12,physics,Middle
2961,1975,35,Fellow of the Royal Society,226,Contenders,2010,1,35,general,Middle
2962,1983,37,MacArthur Fellowship,299,Contenders,2020,0,37,general,Young
2963,2013,7,Nobel Prize in Physiology or Medicine,284,Contenders,2020,0,7,biology,Senior
2964,2018,2,Breakthrough Prize in Life Sciences,624,Contenders,2020,0,2,biology,Middle
2965,2002,4,Shanti Swarup Bhatnagar Prize for Science and Technology,843,Contenders,2006,1,4,general,Young
2966,1963,56,Fellow of the Royal Society,1159,Contenders,2019,0,56,general,Young
2967,1985,34,Claude E. Shannon Award,1093,Contenders,2019,0,34,cs,Middle
2968,1987,33,MacArthur Fellowship,1367,Contenders,2020,0,33,general,Young
2969,2005,11,Wolf Prize in Medicine,126,Contenders,2016,1,11,biology,Senior
2970,2014,6,Breakthrough Prize in Life Sciences,1004,Contenders,2020,0,6,biology,Senior
2971,2000,1,MacArthur Fellowship,381,Contenders,2001,1,1,general,Young
2972,2007,13,Shanti Swarup Bhatnagar Prize for Science and Technology,276,Contenders,2020,0,13,general,Young
2973,2007,11,Fellow of the Royal Society,953,Contenders,2018,0,11,general,Senior
2974,2007,12,Lasker-DeBakey Clinical Medical Research Award,800,Contenders,2019,0,12,biology,Senior
2975,1987,27,Fellow of the Royal Society,1185,Contenders,2014,1,27,general,Young
2976,2013,7,Fellow of the Royal Society,1410,Contenders,2020,0,7,general,Middle
2977,2015,5,Breakthrough Prize in Life Sciences,422,Contenders,2020,0,5,biology,Senior
2978,2017,3,Breakthrough Prize in Life Sciences,63,Contenders,2020,0,3,biology,Senior
2979,2002,5,Nobel Prize in Physiology or Medicine,119,Contenders,2007,1,5,biology,Middle
2980,2011,9,Fellow of the Royal Society,1022,Contenders,2020,0,9,general,NA
2981,1991,11,Fellow of the Royal Society,1307,Contenders,2002,1,11,general,Middle
2982,1998,17,Shanti Swarup Bhatnagar Prize for Science and Technology,812,Contenders,2015,1,17,general,Young
2983,1993,27,Wolf Prize in Chemistry,90,Contenders,2020,0,27,chemistry,Middle
2984,2016,4,Fellow of the Royal Society,319,Contenders,2020,0,4,general,Senior
2985,2015,5,Fellow of the Royal Society,264,Contenders,2020,0,5,general,Senior
2986,2005,13,Fellow of the Royal Society,334,Contenders,2018,0,13,general,Middle
2987,1914,19,Nobel Prize in Physics,1353,Contenders,1933,1,19,physics,Young
2988,1995,24,Wolf Prize in Chemistry,1365,Contenders,2019,0,24,chemistry,Middle
2989,1936,36,Fields Medal,479,Contenders,1972,1,36,mathematics,Young
2990,1994,17,Shanti Swarup Bhatnagar Prize for Science and Technology,687,Contenders,2011,1,17,general,Young
2991,1997,21,Shanti Swarup Bhatnagar Prize for Science and Technology,241,Contenders,2018,0,21,general,Young
2992,1979,6,Wolf Prize in Medicine,1340,Contenders,1985,1,6,biology,Middle
2993,1997,23,Fellow of the Royal Society,611,Contenders,2020,0,23,general,Middle
2994,2002,12,MacArthur Fellowship,574,Contenders,2014,1,12,general,Young
2995,2017,3,Fellow of the Royal Society,1194,Contenders,2020,0,3,general,NA
2996,1993,26,Shanti Swarup Bhatnagar Prize for Science and Technology,586,Contenders,2019,0,26,general,Young
2997,2009,11,Cullum Geographical Medal,846,Contenders,2020,0,11,geography,Senior
2998,1984,23,MacArthur Fellowship,1080,Contenders,2007,1,23,general,Young
3000,1974,34,National Medal of Science,162,Contenders,2008,1,34,general,Senior
3001,2016,4,Wolf Prize in Chemistry,1426,Contenders,2020,0,4,chemistry,Middle
3002,1945,50,Fellow of the Royal Society,1282,Contenders,1995,1,50,general,Young
3003,1989,24,Shanti Swarup Bhatnagar Prize for Science and Technology,596,Contenders,2013,1,24,general,Young
3004,2009,10,Fellow of the Royal Society,1247,Contenders,2019,0,10,general,Young
3005,1994,24,MacArthur Fellowship,321,Contenders,2018,0,24,general,Senior
3006,1976,24,Turing Award,1409,Contenders,2000,1,24,cs,Young
3007,2002,18,Fellow of the Royal Society,216,Contenders,2020,0,18,general,Middle
3008,2006,14,Wolf Prize in Chemistry,79,Contenders,2020,0,14,chemistry,Senior
3009,1972,20,Fellow of the Royal Society,1186,Contenders,1992,1,20,general,Young
3010,2017,2,Fellow of the Royal Society,890,Contenders,2019,0,2,general,NA
3011,1968,45,Fellow of the Royal Society,1245,Contenders,2013,1,45,general,Middle
3012,2010,9,Shanti Swarup Bhatnagar Prize for Science and Technology,265,Contenders,2019,0,9,general,Young
3013,1983,27,Fellow of the Royal Society,588,Contenders,2010,1,27,general,Senior
3014,1991,29,Fellow of the Royal Society,488,Contenders,2020,0,29,general,Young
3015,1988,14,Fellow of the Royal Society,190,Contenders,2002,1,14,general,Senior
3016,1986,23,Nobel Prize in Physiology or Medicine,160,Contenders,2009,1,23,biology,Senior
3017,2004,16,Fellow of the Royal Society,477,Contenders,2020,0,16,general,Middle
3018,2012,8,Shanti Swarup Bhatnagar Prize for Science and Technology,1215,Contenders,2020,0,8,general,Young
3019,2013,7,Fellow of the Royal Society,1055,Contenders,2020,0,7,general,Middle
3021,2018,0,Fellow of the Royal Society,1095,Contenders,2018,0,0,general,NA
3022,1982,28,Lasker-DeBakey Clinical Medical Research Award,592,Contenders,2010,1,28,biology,Middle
3023,1992,18,Fellow of the Royal Society,710,Contenders,2010,1,18,general,Middle
3024,1977,32,Max Planck Medal,480,Contenders,2009,1,32,physics,Middle
3025,2002,8,National Medal of Science,426,Contenders,2010,1,8,general,Senior
3026,2003,17,Lasker-DeBakey Clinical Medical Research Award,604,Contenders,2020,0,17,biology,Senior
3027,2000,2,Fellow of the Royal Society,1281,Contenders,2002,1,2,general,Senior
3028,1982,26,Fellow of the Royal Society,1149,Contenders,2008,1,26,general,Young
3029,2002,17,MacArthur Fellowship,315,Contenders,2019,0,17,general,Young
3030,2003,16,Nobel Prize in Chemistry,1283,Contenders,2019,0,16,chemistry,Middle
3031,1985,33,Claude E. Shannon Award,1093,Contenders,2018,0,33,cs,Middle
3032,2002,17,Fellow of the Royal Society,440,Contenders,2019,0,17,general,Middle
3033,2012,7,National Medal of Science,97,Contenders,2019,0,7,general,Senior
3035,2004,16,Fellow of the Royal Society,31,Contenders,2020,0,16,general,Middle
3036,1983,31,MacArthur Fellowship,1325,Contenders,2014,1,31,general,Middle
3037,1993,17,Shanti Swarup Bhatnagar Prize for Science and Technology,1343,Contenders,2010,1,17,general,Young
3038,2015,5,Shanti Swarup Bhatnagar Prize for Science and Technology,1116,Contenders,2020,0,5,general,Young
3039,2016,4,Fellow of the Royal Society,415,Contenders,2020,0,4,general,Senior
3040,1975,33,Fellow of the Royal Society,1249,Contenders,2008,1,33,general,Middle
3041,2016,4,Fellow of the Royal Society,137,Contenders,2020,0,4,general,NA
3042,2001,18,Fellow of the Royal Society,658,Contenders,2019,0,18,general,Middle
3043,1980,7,Fellow of the Royal Society,1266,Contenders,1987,1,7,general,Middle
3044,2017,3,Fellow of the Royal Society,537,Contenders,2020,0,3,general,Senior
3045,1955,54,Lasker-DeBakey Clinical Medical Research Award,103,Contenders,2009,1,54,biology,Young
3046,2001,19,Fellow of the Royal Society,1210,Contenders,2020,0,19,general,Young
3047,1960,1,Nobel Prize in Physics,1419,Contenders,1961,1,1,physics,Young
3048,2010,10,Shanti Swarup Bhatnagar Prize for Science and Technology,923,Contenders,2020,0,10,general,Young
3049,1987,30,Fellow of the Royal Society,816,Contenders,2017,1,30,general,Young
3050,2011,3,Fellow of the Royal Society,55,Contenders,2014,1,3,general,Middle
3051,2011,9,MacArthur Fellowship,651,Contenders,2020,0,9,general,Young
3052,1995,24,Fellow of the Royal Society,1257,Contenders,2019,0,24,general,Young
3053,1944,9,Nobel Prize in Physics,1285,Contenders,1953,1,9,physics,Middle
3054,2001,18,Fellow of the Royal Society,986,Contenders,2019,0,18,general,Middle
3055,2007,13,Fellow of the Royal Society,1263,Contenders,2020,0,13,general,Senior
3056,2003,17,Fellow of the Royal Society,789,Contenders,2020,0,17,general,Middle
3057,1965,25,Fellow of the Royal Society,1202,Contenders,1990,1,25,general,Young
3058,1999,21,Fellow of the Royal Society,1390,Contenders,2020,0,21,general,Young
3059,2008,0,MacArthur Fellowship,233,Contenders,2008,1,0,general,Young
3060,1995,25,Fellow of the Royal Society,1274,Contenders,2020,0,25,general,Middle
3061,2017,3,Fellow of the Royal Society,576,Contenders,2020,0,3,general,NA
3062,2009,11,MacArthur Fellowship,75,Contenders,2020,0,11,general,Middle
3063,2012,5,Wolf Prize in Medicine,970,Contenders,2017,1,5,biology,Senior
3064,2002,17,Shanti Swarup Bhatnagar Prize for Science and Technology,1015,Contenders,2019,0,17,general,Young
3065,1968,41,National Medal of Science,1332,Contenders,2009,1,41,general,Senior
3067,2010,10,Fellow of the Royal Society,493,Contenders,2020,0,10,general,Middle
3068,1996,24,Fellow of the Royal Society,335,Contenders,2020,0,24,general,Middle
3069,1946,30,Fellow of the Royal Society,782,Contenders,1976,1,30,general,Senior
3070,1989,30,Fellow of the Royal Society,524,Contenders,2019,0,30,general,Young
3071,2002,18,Shanti Swarup Bhatnagar Prize for Science and Technology,1015,Contenders,2020,0,18,general,Young
3072,1994,25,Fellow of the Royal Society,548,Contenders,2019,0,25,general,Middle
3073,1952,36,Fellow of the Royal Society,1377,Contenders,1988,1,36,general,Middle
3074,2001,19,National Medal of Science,951,Contenders,2020,0,19,general,Senior
3075,1990,30,Fellow of the Royal Society,519,Contenders,2020,0,30,general,NA
3076,1955,19,Lasker-DeBakey Clinical Medical Research Award,103,Contenders,1974,1,19,biology,Young
3077,1986,22,Fellow of the Royal Society,99,Contenders,2008,1,22,general,Young
3078,2005,15,Fellow of the Royal Society,29,Contenders,2020,0,15,general,Middle
3079,1971,1,Fellow of the Royal Society,667,Contenders,1972,1,1,general,Young
3080,2004,16,Wolf Prize in Medicine,288,Contenders,2020,0,16,biology,Middle
3081,2009,10,Shanti Swarup Bhatnagar Prize for Science and Technology,431,Contenders,2019,0,10,general,Young
3082,1992,6,MacArthur Fellowship,1092,Contenders,1998,1,6,general,Middle
3083,2001,18,MacArthur Fellowship,78,Contenders,2019,0,18,general,NA
3084,1972,35,Fellow of the Royal Society,1186,Contenders,2007,1,35,general,Young
3085,2012,8,Fellow of the Royal Society,184,Contenders,2020,0,8,general,Middle
3086,1990,29,Shanti Swarup Bhatnagar Prize for Science and Technology,67,Contenders,2019,0,29,general,Young
3087,1999,15,MacArthur Fellowship,104,Contenders,2014,1,15,general,Young
3088,1964,43,Fellow of the Royal Society,310,Contenders,2007,1,43,general,Middle
3089,2005,15,MacArthur Fellowship,146,Contenders,2020,0,15,general,Young
3090,2009,11,Fellow of the Royal Society,539,Contenders,2020,0,11,general,NA
3091,1999,20,Fellow of the Royal Society,805,Contenders,2019,0,20,general,Middle
3092,2007,12,Hughes Medal,139,Contenders,2019,0,12,physics,Middle
3093,2017,2,Fellow of the Royal Society,711,Contenders,2019,0,2,general,Senior
3094,2010,9,Lyell Medal,881,Contenders,2019,0,9,geography,Senior
3095,1977,2,Fellow of the Royal Society,818,Contenders,1979,1,2,general,Young
3096,1991,20,Wolf Prize in Physics,1452,Contenders,2011,1,20,physics,Senior
3097,2013,7,SASTRA Ramanujan Prize,829,Contenders,2020,0,7,mathematics,Young
3098,1938,2,Fellow of the Royal Society,744,Contenders,1940,1,2,general,Young
3099,1989,23,Fellow of the Royal Society,1414,Contenders,2012,1,23,general,Senior
3100,1992,28,Shanti Swarup Bhatnagar Prize for Science and Technology,974,Contenders,2020,0,28,general,Young
3101,1981,30,Nobel Prize in Chemistry,593,Contenders,2011,1,30,chemistry,Senior
3102,2011,9,MacArthur Fellowship,680,Contenders,2020,0,9,general,Young
3103,1971,43,Fellow of the Royal Society,867,Contenders,2014,1,43,general,Young
3104,1991,15,Nobel Prize in Physiology or Medicine,161,Contenders,2006,1,15,biology,Middle
3105,1997,19,Max Planck Medal,1258,Contenders,2016,1,19,physics,Senior
3106,1992,24,Shanti Swarup Bhatnagar Prize for Science and Technology,974,Contenders,2016,1,24,general,Young
3107,1995,24,Turing Award,1017,Contenders,2019,0,24,cs,Middle
3108,2012,8,Shanti Swarup Bhatnagar Prize for Science and Technology,1215,Contenders,2020,0,8,general,Young
3109,1966,24,Fellow of the Royal Society,731,Contenders,1990,1,24,general,Young
3110,1974,32,Fellow of the Royal Society,316,Contenders,2006,1,32,general,Young
3111,1996,10,Nobel Prize in Physics,1132,Contenders,2006,1,10,physics,Senior
3112,2003,17,MacArthur Fellowship,977,Contenders,2020,0,17,general,Middle
3113,2011,9,Fellow of the Royal Society,509,Contenders,2020,0,9,general,Middle
3114,1994,11,National Medal of Science,1397,Contenders,2005,1,11,general,Senior
3115,1995,10,Wolf Prize in Physics,1113,Contenders,2005,1,10,physics,Senior
3116,2000,20,Fellow of the Royal Society,1281,Contenders,2020,0,20,general,Senior
3117,1982,37,Wollaston Medal,258,Contenders,2019,0,37,geography,Middle
3118,2002,18,Fellow of the Royal Society,1033,Contenders,2020,0,18,general,Middle
3119,2014,6,Fellow of the Royal Society,41,Contenders,2020,0,6,general,Middle
3120,1980,28,Fellow of the Royal Society,1266,Contenders,2008,1,28,general,Middle
3121,1956,32,Lasker-DeBakey Clinical Medical Research Award,390,Contenders,1988,1,32,biology,Young
3122,1990,29,Fellow of the Royal Society,758,Contenders,2019,0,29,general,Young
3123,2007,13,Fellow of the Royal Society,649,Contenders,2020,0,13,general,Senior
3124,1994,18,Shanti Swarup Bhatnagar Prize for Science and Technology,269,Contenders,2012,1,18,general,Young
3125,1990,29,Fellow of the Royal Society,279,Contenders,2019,0,29,general,Middle
3126,1999,20,Fellow of the Royal Society,609,Contenders,2019,0,20,general,Middle
3127,1964,24,Nobel Prize in Physiology or Medicine,1424,Contenders,1988,1,24,biology,Middle
3128,1982,36,Fields Medal,1174,Contenders,2018,0,36,mathematics,Young
3129,1986,6,Wolf Prize in Chemistry,232,Contenders,1992,1,6,chemistry,Senior
3130,2010,10,Fellow of the Royal Society,271,Contenders,2020,0,10,general,Middle
3131,1983,35,Fellow of the Royal Society,1438,Contenders,2018,0,35,general,Middle
3132,2012,5,Abel Prize,877,Contenders,2017,1,5,mathematics,Senior
3133,2006,14,MacArthur Fellowship,385,Contenders,2020,0,14,general,Young
3134,1990,29,MacArthur Fellowship,1199,Contenders,2019,0,29,general,Young
3135,2008,12,Wolf Prize in Chemistry,107,Contenders,2020,0,12,chemistry,Middle
3136,1991,29,Fellow of the Royal Society,394,Contenders,2020,0,29,general,Middle
3137,2005,12,National Medal of Science,130,Contenders,2017,1,12,general,Senior
3139,2016,1,Wolf Prize in Physics,23,Contenders,2017,1,1,physics,Senior
3140,1988,32,MacArthur Fellowship,639,Contenders,2020,0,32,general,Young
3141,2008,12,MacArthur Fellowship,462,Contenders,2020,0,12,general,Young
3142,1967,53,Fellow of the Royal Society,856,Contenders,2020,0,53,general,Young
3143,2013,5,Fellow of the Royal Society,512,Contenders,2018,0,5,general,Senior
3144,2007,13,Shanti Swarup Bhatnagar Prize for Science and Technology,350,Contenders,2020,0,13,general,NA
3145,1978,22,Fields Medal,38,Contenders,2000,1,22,mathematics,Young
3146,2017,3,Fellow of the Royal Society,897,Contenders,2020,0,3,general,Middle
3147,2011,9,Fellow of the Royal Society,1022,Contenders,2020,0,9,general,NA
3148,1985,11,Fellow of the Royal Society,1406,Contenders,1996,1,11,general,Young
3149,1980,28,Nobel Prize in Physics,879,Contenders,2008,1,28,physics,Middle
3150,2017,2,Fellow of the Royal Society,320,Contenders,2019,0,2,general,Middle
3151,2001,16,Nobel Prize in Physics,69,Contenders,2017,1,16,physics,Young
3152,2006,13,MacArthur Fellowship,458,Contenders,2019,0,13,general,Middle
3153,1987,25,MacArthur Fellowship,464,Contenders,2012,1,25,general,Young
3154,2012,4,Wolf Prize in Chemistry,497,Contenders,2016,1,4,chemistry,Middle
3155,2015,5,Nobel Prize in Physiology or Medicine,234,Contenders,2020,0,5,biology,Senior
3156,2014,6,Nobel Prize in Physics,1280,Contenders,2020,0,6,physics,Middle
3157,2017,3,Fellow of the Royal Society,358,Contenders,2020,0,3,general,Senior
3158,2012,7,Shanti Swarup Bhatnagar Prize for Science and Technology,1013,Contenders,2019,0,7,general,Senior
3159,1975,42,Fellow of the Royal Society,169,Contenders,2017,1,42,general,Middle
3160,1930,13,Nobel Prize in Chemistry,774,Contenders,1943,1,13,chemistry,Middle
3161,1975,32,Fellow of the Royal Society,1249,Contenders,2007,1,32,general,Middle
3162,2015,5,Shanti Swarup Bhatnagar Prize for Science and Technology,1116,Contenders,2020,0,5,general,Young
3163,2002,18,Lasker-DeBakey Clinical Medical Research Award,413,Contenders,2020,0,18,biology,Senior
3164,2002,18,Fellow of the Royal Society,1152,Contenders,2020,0,18,general,Middle
3165,2017,3,Breakthrough Prize in Life Sciences,37,Contenders,2020,0,3,biology,Senior
3166,2009,11,National Medal of Science,928,Contenders,2020,0,11,general,Middle
3167,2001,18,Fellow of the Royal Society,643,Contenders,2019,0,18,general,NA
3168,2011,9,National Medal of Science,683,Contenders,2020,0,9,general,Senior
3169,1993,25,Shanti Swarup Bhatnagar Prize for Science and Technology,610,Contenders,2018,0,25,general,Young
3170,2002,17,MacArthur Fellowship,62,Contenders,2019,0,17,general,Young
3171,2017,2,Wolf Prize in Physics,632,Contenders,2019,0,2,physics,Senior
3172,2015,4,Claude E. Shannon Award,1147,Contenders,2019,0,4,cs,Senior
3173,2010,10,Willard Gibbs Award,131,Contenders,2020,0,10,chemistry,Senior
3174,2011,5,MacArthur Fellowship,771,Contenders,2016,1,5,general,Young
3176,2015,5,Fellow of the Royal Society,727,Contenders,2020,0,5,general,Senior
3177,2014,6,National Medal of Science,1256,Contenders,2020,0,6,general,Senior
3178,2003,17,Lasker-DeBakey Clinical Medical Research Award,587,Contenders,2020,0,17,biology,Middle
3179,1989,24,Shanti Swarup Bhatnagar Prize for Science and Technology,502,Contenders,2013,1,24,general,Young
3180,2017,2,Nobel Prize in Physics,188,Contenders,2019,0,2,physics,Senior
3183,1993,27,Wolf Prize in Chemistry,90,Contenders,2020,0,27,chemistry,Middle
3185,2015,5,Fellow of the Royal Society,455,Contenders,2020,0,5,general,NA
3187,1973,38,Fellow of the Royal Society,1109,Contenders,2011,1,38,general,Young
3188,2010,10,National Medal of Science,1284,Contenders,2020,0,10,general,Senior
3189,2010,10,Shanti Swarup Bhatnagar Prize for Science and Technology,791,Contenders,2020,0,10,general,Young
3190,2004,13,National Medal of Science,1111,Contenders,2017,1,13,general,Senior
3191,1989,31,Edison Medal,638,Contenders,2020,0,31,cs,Senior
3192,2008,11,Fellow of the Royal Society,352,Contenders,2019,0,11,general,Young
3193,2010,9,Fields Medal,920,Contenders,2019,0,9,mathematics,Young
3194,2008,12,Fellow of the Royal Society,219,Contenders,2020,0,12,general,Young
3195,2007,0,Willard Gibbs Award,435,Contenders,2007,1,0,chemistry,Middle
3196,2016,4,Fellow of the Royal Society,1012,Contenders,2020,0,4,general,NA
3197,2007,13,Fellow of the Royal Society,1446,Contenders,2020,0,13,general,Middle
3198,2016,4,Lasker-DeBakey Clinical Medical Research Award,193,Contenders,2020,0,4,biology,Middle
3199,1993,27,Willard Gibbs Award,189,Contenders,2020,0,27,chemistry,Middle
3200,1987,27,Shanti Swarup Bhatnagar Prize for Science and Technology,1029,Contenders,2014,1,27,general,Young
3201,2011,4,MacArthur Fellowship,835,Contenders,2015,1,4,general,Young
3202,1982,38,MacArthur Fellowship,857,Contenders,2020,0,38,general,Middle
3203,1994,25,Shanti Swarup Bhatnagar Prize for Science and Technology,269,Contenders,2019,0,25,general,Young
3204,1997,22,Fellow of the Royal Society,729,Contenders,2019,0,22,general,Middle
3205,2014,6,Nobel Prize in Physics,921,Contenders,2020,0,6,physics,Middle
3206,1992,25,Fellow of the Royal Society,557,Contenders,2017,1,25,general,Middle
3207,2007,10,Shanti Swarup Bhatnagar Prize for Science and Technology,1032,Contenders,2017,1,10,general,NA
3208,1939,24,Fellow of the Royal Society,1187,Contenders,1963,1,24,general,Young
3209,1997,22,Fellow of the Royal Society,451,Contenders,2019,0,22,general,Middle
3212,1982,29,MacArthur Fellowship,1384,Contenders,2011,1,29,general,Young
3213,2004,9,Shanti Swarup Bhatnagar Prize for Science and Technology,817,Contenders,2013,1,9,general,Young
3214,2017,3,Fellow of the Royal Society,866,Contenders,2020,0,3,general,Middle
3215,1990,24,National Medal of Science,353,Contenders,2014,1,24,general,Senior
3216,1994,21,Fellow of the Royal Society,408,Contenders,2015,1,21,general,Young
3217,1982,38,MacArthur Fellowship,536,Contenders,2020,0,38,general,Young
3218,2007,13,Fellow of the Royal Society,712,Contenders,2020,0,13,general,Senior
3219,1979,3,Fellow of the Royal Society,393,Contenders,1982,1,3,general,Middle
3220,1968,38,Nobel Prize in Physiology or Medicine,1200,Contenders,2006,1,38,biology,Middle
3221,2014,5,Lasker-DeBakey Clinical Medical Research Award,1260,Contenders,2019,0,5,biology,NA
3222,1999,21,MacArthur Fellowship,104,Contenders,2020,0,21,general,Young
3223,1940,68,Fellow of the Royal Society,364,Contenders,2008,1,68,general,Young
3224,1943,0,Nobel Prize in Physiology or Medicine,946,Contenders,1943,1,0,biology,Middle
3225,1975,40,Shanti Swarup Bhatnagar Prize for Science and Technology,1359,Contenders,2015,1,40,general,Young
3226,1998,20,Shanti Swarup Bhatnagar Prize for Science and Technology,1148,Contenders,2018,0,20,general,Young
3227,1971,26,Fellow of the Royal Society,242,Contenders,1997,1,26,general,Middle
3228,1901,41,Fellow of the Royal Society,706,Contenders,1942,1,41,general,Young
3229,2011,8,Fellow of the Royal Society,65,Contenders,2019,0,8,general,Middle
3230,1973,16,Shanti Swarup Bhatnagar Prize for Science and Technology,1192,Contenders,1989,1,16,general,Young
3231,1995,2,Nobel Prize in Chemistry,625,Contenders,1997,1,2,chemistry,Middle
3232,2002,17,Shanti Swarup Bhatnagar Prize for Science and Technology,527,Contenders,2019,0,17,general,Young
3233,1994,18,Willard Gibbs Award,325,Contenders,2012,1,18,chemistry,Senior
3234,1981,23,MacArthur Fellowship,959,Contenders,2004,1,23,general,Young
3235,2004,15,Fellow of the Royal Society,1110,Contenders,2019,0,15,general,Senior
3236,2015,4,Nobel Prize in Chemistry,1244,Contenders,2019,0,4,chemistry,Senior
3237,1993,2,MacArthur Fellowship,863,Contenders,1995,1,2,general,Young
3238,1978,13,Fellow of the Royal Society,1411,Contenders,1991,1,13,general,Young
3239,2006,13,Shanti Swarup Bhatnagar Prize for Science and Technology,30,Contenders,2019,0,13,general,Young
3240,1978,14,Nobel Prize in Physiology or Medicine,5,Contenders,1992,1,14,biology,Middle
3241,1996,24,Shanti Swarup Bhatnagar Prize for Science and Technology,838,Contenders,2020,0,24,general,Young
3244,2002,8,Fellow of the Royal Society,616,Contenders,2010,1,8,general,Middle
3245,2000,11,Fellow of the Royal Society,787,Contenders,2011,1,11,general,Middle
3246,2004,16,Nobel Prize in Physiology or Medicine,332,Contenders,2020,0,16,biology,Middle
3247,2014,6,Lasker-DeBakey Clinical Medical Research Award,1260,Contenders,2020,0,6,biology,NA
3249,1993,25,Wolf Prize in Chemistry,90,Contenders,2018,0,25,chemistry,Middle
3250,2012,6,Nobel Prize in Physics,1078,Contenders,2018,0,6,physics,Senior
3251,1999,19,Nobel Prize in Physiology or Medicine,277,Contenders,2018,0,19,biology,Senior
3253,1984,30,Nobel Prize in Chemistry,573,Contenders,2014,1,30,chemistry,Senior
3254,2016,3,Fellow of the Royal Society,415,Contenders,2019,0,3,general,Senior
3255,1989,30,Shanti Swarup Bhatnagar Prize for Science and Technology,502,Contenders,2019,0,30,general,Young
3256,1987,33,Fellow of the Royal Society,553,Contenders,2020,0,33,general,Middle
3257,1998,5,Shanti Swarup Bhatnagar Prize for Science and Technology,1148,Contenders,2003,1,5,general,Young
3258,1993,26,MacArthur Fellowship,84,Contenders,2019,0,26,general,Middle
3259,2002,18,Shanti Swarup Bhatnagar Prize for Science and Technology,869,Contenders,2020,0,18,general,Young
3260,2007,13,Fellow of the Royal Society,47,Contenders,2020,0,13,general,Middle
3261,2015,5,Fellow of the Royal Society,529,Contenders,2020,0,5,general,NA
3262,1941,17,Fellow of the Royal Society,1218,Contenders,1958,1,17,general,Young
3263,1947,11,Nobel Prize in Physiology or Medicine,261,Contenders,1958,1,11,biology,Middle
3264,1936,67,Willard Gibbs Award,1226,Contenders,2003,1,67,chemistry,Middle
3265,2002,3,Fellow of the Royal Society,141,Contenders,2005,1,3,general,Senior
3266,2016,4,Lasker-DeBakey Clinical Medical Research Award,1125,Contenders,2020,0,4,biology,Senior
3267,2002,18,Wolf Prize in Physics,809,Contenders,2020,0,18,physics,Senior
3268,1984,32,MacArthur Fellowship,166,Contenders,2016,1,32,general,Middle
3269,2000,16,Marconi Prize,1206,Contenders,2016,1,16,cs,Middle
3270,2002,4,Wollaston Medal,1240,Contenders,2006,1,4,geography,Senior
3271,2011,9,MacArthur Fellowship,786,Contenders,2020,0,9,general,Young
3272,2007,13,Fellow of the Royal Society,147,Contenders,2020,0,13,general,Middle
3273,2017,2,Fellow of the Royal Society,890,Contenders,2019,0,2,general,NA
3274,2009,11,Nobel Prize in Physiology or Medicine,231,Contenders,2020,0,11,biology,Middle
3276,1994,24,Shanti Swarup Bhatnagar Prize for Science and Technology,1071,Contenders,2018,0,24,general,Young
3277,2007,2,Fellow of the Royal Society,1143,Contenders,2009,1,2,general,NA
3278,2007,13,MacArthur Fellowship,841,Contenders,2020,0,13,general,Young
3279,2013,7,Breakthrough Prize in Life Sciences,391,Contenders,2020,0,7,biology,Senior
3280,1971,36,Fellow of the Royal Society,1279,Contenders,2007,1,36,general,Young
3281,1989,18,Nobel Prize in Physics,70,Contenders,2007,1,18,physics,Senior
3282,1990,27,Fellow of the Royal Society,535,Contenders,2017,1,27,general,Middle
3283,2002,16,Fellow of the Royal Society,616,Contenders,2018,0,16,general,Middle
3284,2006,14,Fellow of the Royal Society,1139,Contenders,2020,0,14,general,Middle
3285,1991,22,Fellow of the Royal Society,282,Contenders,2013,1,22,general,Young
3286,2012,1,National Medal of Science,1077,Contenders,2013,1,1,general,Senior
3287,2001,15,Fellow of the Royal Society,128,Contenders,2016,1,15,general,Middle
3288,2012,1,Wolf Prize in Chemistry,497,Contenders,2013,1,1,chemistry,Middle
3289,2013,7,MacArthur Fellowship,840,Contenders,2020,0,7,general,Young
3290,2009,11,Shanti Swarup Bhatnagar Prize for Science and Technology,1394,Contenders,2020,0,11,general,Young
3291,2009,11,MacArthur Fellowship,1108,Contenders,2020,0,11,general,Young
3292,2000,19,Fellow of the Royal Society,194,Contenders,2019,0,19,general,Middle
3293,1999,21,Fellow of the Royal Society,1228,Contenders,2020,0,21,general,NA
3294,1992,27,Fellow of the Royal Society,571,Contenders,2019,0,27,general,Middle
3295,1980,31,Fellow of the Royal Society,1265,Contenders,2011,1,31,general,NA
3296,1995,14,Wolf Prize in Chemistry,1365,Contenders,2009,1,14,chemistry,Middle
3297,2000,2,Fellow of the Royal Society,1102,Contenders,2002,1,2,general,Middle
3298,2011,9,Fellow of the Royal Society,853,Contenders,2020,0,9,general,Senior
3299,1999,20,Fellow of the Royal Society,852,Contenders,2019,0,20,general,Middle
3300,1998,17,MacArthur Fellowship,884,Contenders,2015,1,17,general,Young
3301,1990,29,Shanti Swarup Bhatnagar Prize for Science and Technology,926,Contenders,2019,0,29,general,Young
3302,1995,19,MacArthur Fellowship,788,Contenders,2014,1,19,general,Young
3303,1999,21,Fellow of the Royal Society,133,Contenders,2020,0,21,general,Senior
3304,2000,20,MacArthur Fellowship,775,Contenders,2020,0,20,general,Young
3305,1999,21,Fellow of the Royal Society,1049,Contenders,2020,0,21,general,Middle
3306,1947,27,Fellow of the Royal Society,1398,Contenders,1974,1,27,general,Middle
3307,1993,25,Shanti Swarup Bhatnagar Prize for Science and Technology,586,Contenders,2018,0,25,general,Young
3309,2008,4,Wolf Prize in Medicine,815,Contenders,2012,1,4,biology,Senior
3310,2005,15,Nobel Prize in Chemistry,140,Contenders,2020,0,15,chemistry,Middle
3311,2009,5,Wollaston Medal,1296,Contenders,2014,1,5,geography,Senior
3312,2012,8,MacArthur Fellowship,4,Contenders,2020,0,8,general,Young
3314,1994,26,Fellow of the Royal Society,408,Contenders,2020,0,26,general,Young
3315,2007,12,Fellow of the Royal Society,147,Contenders,2019,0,12,general,Middle
3316,2002,11,Fellow of the Royal Society,141,Contenders,2013,1,11,general,Senior
3317,1973,33,National Medal of Science,1073,Contenders,2006,1,33,general,Senior
3318,2003,10,Fellow of the Royal Society,297,Contenders,2013,1,10,general,Senior
3319,2013,7,Fellow of the Royal Society,939,Contenders,2020,0,7,general,NA
3320,2012,8,National Medal of Science,700,Contenders,2020,0,8,general,Senior
3321,1975,28,Fellow of the Royal Society,169,Contenders,2003,1,28,general,Middle
3322,1986,17,Fellow of the Royal Society,949,Contenders,2003,1,17,general,Middle
3323,1903,110,Fellow of the Royal Society,1040,Contenders,2013,1,110,general,Young
3324,2012,7,Fellow of the Royal Society,962,Contenders,2019,0,7,general,Senior
3325,1992,26,Fellow of the Royal Society,1267,Contenders,2018,0,26,general,Middle
3326,2007,12,Fellow of the Royal Society,27,Contenders,2019,0,12,general,Young
3327,2011,9,Shanti Swarup Bhatnagar Prize for Science and Technology,260,Contenders,2020,0,9,general,Young
3328,2003,17,MacArthur Fellowship,1362,Contenders,2020,0,17,general,Young
3329,1994,26,MacArthur Fellowship,191,Contenders,2020,0,26,general,Young
3330,1986,11,Fellow of the Royal Society,949,Contenders,1997,1,11,general,Middle
3331,1995,25,Shanti Swarup Bhatnagar Prize for Science and Technology,979,Contenders,2020,0,25,general,Young
3332,1988,2,MacArthur Fellowship,865,Contenders,1990,1,2,general,Young
3333,2015,4,Claude E. Shannon Award,1147,Contenders,2019,0,4,cs,Senior
3334,1994,25,Fellow of the Royal Society,664,Contenders,2019,0,25,general,Young
3335,2010,9,Nobel Prize in Chemistry,224,Contenders,2019,0,9,chemistry,Senior
3336,2015,5,Fellow of the Royal Society,1097,Contenders,2020,0,5,general,NA
3337,2012,8,MacArthur Fellowship,4,Contenders,2020,0,8,general,Young
3338,2005,13,Fellow of the Royal Society,941,Contenders,2018,0,13,general,Middle
3339,2001,1,Cullum Geographical Medal,652,Contenders,2002,1,1,geography,Senior
3340,2008,11,Shanti Swarup Bhatnagar Prize for Science and Technology,105,Contenders,2019,0,11,general,Young
3341,1975,34,Fellow of the Royal Society,1249,Contenders,2009,1,34,general,Middle
3342,1997,17,Fellow of the Royal Society,1006,Contenders,2014,1,17,general,Middle
3343,1994,12,Fellow of the Royal Society,896,Contenders,2006,1,12,general,Middle
3344,1984,34,Fellow of the Royal Society,1126,Contenders,2018,0,34,general,Young
3345,1981,14,Wollaston Medal,1155,Contenders,1995,1,14,geography,Senior
3346,2003,17,Lasker-DeBakey Clinical Medical Research Award,587,Contenders,2020,0,17,biology,Middle
3347,2016,2,Fellow of the Royal Society,549,Contenders,2018,0,2,general,Senior
3348,1988,31,MacArthur Fellowship,639,Contenders,2019,0,31,general,Young
3349,1982,38,MacArthur Fellowship,536,Contenders,2020,0,38,general,Young
3350,2001,14,MacArthur Fellowship,164,Contenders,2015,1,14,general,Young
3351,1987,28,Wolf Prize in Medicine,6,Contenders,2015,1,28,biology,Middle
3352,2017,2,Fellow of the Royal Society,963,Contenders,2019,0,2,general,Senior
3353,1998,21,Lasker-DeBakey Clinical Medical Research Award,1262,Contenders,2019,0,21,biology,Senior
3354,2005,15,National Medal of Science,1039,Contenders,2020,0,15,general,Middle
3355,2002,17,Lasker-DeBakey Clinical Medical Research Award,1075,Contenders,2019,0,17,biology,Senior
3356,2011,8,Shanti Swarup Bhatnagar Prize for Science and Technology,1028,Contenders,2019,0,8,general,Young
3357,1972,36,Fellow of the Royal Society,696,Contenders,2008,1,36,general,Middle
3358,1991,29,Fellow of the Royal Society,178,Contenders,2020,0,29,general,Middle
3359,2006,13,Fellow of the Royal Society,1005,Contenders,2019,0,13,general,Middle
3360,2009,11,Nobel Prize in Physiology or Medicine,345,Contenders,2020,0,11,biology,Middle
3361,2014,6,Lasker-DeBakey Clinical Medical Research Award,1175,Contenders,2020,0,6,biology,Senior
3362,2017,3,Fellow of the Royal Society,866,Contenders,2020,0,3,general,Middle
3363,2015,5,Max Planck Medal,287,Contenders,2020,0,5,physics,Middle
3364,2006,14,Fellow of the Royal Society,847,Contenders,2020,0,14,general,NA
3365,2012,8,Fellow of the Royal Society,957,Contenders,2020,0,8,general,Young
3366,2007,13,Fellow of the Royal Society,1312,Contenders,2020,0,13,general,Middle
3367,1995,24,Fellow of the Royal Society,602,Contenders,2019,0,24,general,Middle
3368,1983,9,National Medal of Science,740,Contenders,1992,1,9,general,Senior
3369,2000,5,MacArthur Fellowship,741,Contenders,2005,1,5,general,Young
3370,2016,4,Fellow of the Royal Society,971,Contenders,2020,0,4,general,Middle
3371,2016,4,Nobel Prize in Chemistry,185,Contenders,2020,0,4,chemistry,Senior
3372,1989,19,National Medal of Science,112,Contenders,2008,1,19,general,Senior
3374,2006,13,Fellow of the Royal Society,847,Contenders,2019,0,13,general,NA
3375,1983,36,Wolf Prize in Chemistry,1352,Contenders,2019,0,36,chemistry,Middle
3376,2010,10,Lyell Medal,881,Contenders,2020,0,10,geography,Senior
3377,2001,17,Fellow of the Royal Society,568,Contenders,2018,0,17,general,Middle
3378,2010,10,MacArthur Fellowship,122,Contenders,2020,0,10,general,Young
3379,2000,19,Fellow of the Royal Society,194,Contenders,2019,0,19,general,Middle
3380,1989,31,Fellow of the Royal Society,420,Contenders,2020,0,31,general,Young
3381,1994,13,Fellow of the Royal Society,376,Contenders,2007,1,13,general,Middle
3382,1986,20,Fellow of the Royal Society,949,Contenders,2006,1,20,general,Middle
3383,1978,41,Fields Medal,38,Contenders,2019,0,41,mathematics,Young
3384,2008,10,MacArthur Fellowship,233,Contenders,2018,0,10,general,Young
3385,1993,22,National Medal of Science,487,Contenders,2015,1,22,general,Senior
3386,1991,4,MacArthur Fellowship,626,Contenders,1995,1,4,general,Senior
3387,2013,7,Breakthrough Prize in Life Sciences,759,Contenders,2020,0,7,biology,Middle
3388,1983,29,MacArthur Fellowship,117,Contenders,2012,1,29,general,Young
3389,1994,19,Fellow of the Royal Society,377,Contenders,2013,1,19,general,Young
3390,2008,12,Fellow of the Royal Society,54,Contenders,2020,0,12,general,Senior
3391,1992,13,Fellow of the Royal Society,702,Contenders,2005,1,13,general,Middle
3392,1992,28,Fellow of the Royal Society,702,Contenders,2020,0,28,general,Middle
3393,1984,0,Turing Award,1224,Contenders,1984,1,0,cs,Middle
3394,2009,11,MacArthur Fellowship,1108,Contenders,2020,0,11,general,Young
3395,2010,2,Shanti Swarup Bhatnagar Prize for Science and Technology,634,Contenders,2012,1,2,general,Young
3396,1993,27,National Medal of Science,1212,Contenders,2020,0,27,general,Senior
3397,1970,28,National Medal of Science,338,Contenders,1998,1,28,general,Middle
3398,2005,11,National Medal of Science,130,Contenders,2016,1,11,general,Senior
3399,2016,4,Fellow of the Royal Society,430,Contenders,2020,0,4,general,NA
3400,2000,20,Shanti Swarup Bhatnagar Prize for Science and Technology,386,Contenders,2020,0,20,general,NA
3401,1983,20,Shanti Swarup Bhatnagar Prize for Science and Technology,1428,Contenders,2003,1,20,general,Young
3402,1991,4,MacArthur Fellowship,547,Contenders,1995,1,4,general,Young
3403,1996,20,Fellow of the Royal Society,327,Contenders,2016,1,20,general,Middle
3404,1980,28,Shanti Swarup Bhatnagar Prize for Science and Technology,1466,Contenders,2008,1,28,general,Young
3405,2011,8,Shanti Swarup Bhatnagar Prize for Science and Technology,1153,Contenders,2019,0,8,general,NA
3407,1993,27,MacArthur Fellowship,839,Contenders,2020,0,27,general,Middle
3408,1981,12,National Medal of Science,1007,Contenders,1993,1,12,general,Senior
3409,1998,22,Nobel Prize in Physics,1106,Contenders,2020,0,22,physics,Middle
3410,2007,13,Turing Award,722,Contenders,2020,0,13,cs,Middle
3412,2003,8,Fellow of the Royal Society,842,Contenders,2011,1,8,general,Middle
3413,2003,13,Fellow of the Royal Society,503,Contenders,2016,1,13,general,Senior
3414,2002,1,Fellow of the Royal Society,216,Contenders,2003,1,1,general,Middle
3415,1997,23,Nobel Prize in Physics,1248,Contenders,2020,0,23,physics,Middle
3416,2018,2,Fellow of the Royal Society,516,Contenders,2020,0,2,general,Middle
3417,1974,36,Fellow of the Royal Society,1382,Contenders,2010,1,36,general,Middle
3418,1984,35,Nobel Prize in Physics,506,Contenders,2019,0,35,physics,Middle
3419,2007,13,Fellow of the Royal Society,927,Contenders,2020,0,13,general,Middle
3420,1996,22,Shanti Swarup Bhatnagar Prize for Science and Technology,838,Contenders,2018,0,22,general,Young
3421,1981,39,Nobel Prize in Chemistry,593,Contenders,2020,0,39,chemistry,Senior
3422,1991,29,National Medal of Science,1057,Contenders,2020,0,29,general,Middle
3423,1995,7,Nobel Prize in Chemistry,625,Contenders,2002,1,7,chemistry,Middle
3424,2001,18,Fellow of the Royal Society,837,Contenders,2019,0,18,general,Middle
3425,2013,7,Fellow of the Royal Society,1055,Contenders,2020,0,7,general,Middle
3426,2015,4,Fellow of the Royal Society,12,Contenders,2019,0,4,general,Senior
3427,1978,18,Wolf Prize in Medicine,1391,Contenders,1996,1,18,biology,Middle
3428,1967,4,Shanti Swarup Bhatnagar Prize for Science and Technology,1082,Contenders,1971,1,4,general,Young
3429,1992,21,MacArthur Fellowship,134,Contenders,2013,1,21,general,Middle
3430,1996,23,Fellow of the Royal Society,1417,Contenders,2019,0,23,general,Young
3431,2008,12,MacArthur Fellowship,442,Contenders,2020,0,12,general,NA
3432,1994,23,Fellow of the Royal Society,1161,Contenders,2017,1,23,general,Young
3433,2006,5,National Medal of Science,1420,Contenders,2011,1,5,general,Senior
3434,2007,13,Shanti Swarup Bhatnagar Prize for Science and Technology,1041,Contenders,2020,0,13,general,Young
3435,2006,14,Shanti Swarup Bhatnagar Prize for Science and Technology,1166,Contenders,2020,0,14,general,Young
3436,1971,33,Fellow of the Royal Society,1279,Contenders,2004,1,33,general,Young
3437,1989,15,Nobel Prize in Physics,70,Contenders,2004,1,15,physics,Senior
3438,1992,21,MacArthur Fellowship,134,Contenders,2013,1,21,general,Middle
3439,1952,67,Fellow of the Royal Society,561,Contenders,2019,0,67,general,Young
3440,1964,0,Nobel Prize in Physics,379,Contenders,1964,1,0,physics,Young
3441,2002,18,Wolf Prize in Physics,809,Contenders,2020,0,18,physics,Senior
3442,2008,11,Wolf Prize in Medicine,16,Contenders,2019,0,11,biology,Senior
3443,2001,19,Fellow of the Royal Society,496,Contenders,2020,0,19,general,Middle
3444,2016,4,Fellow of the Royal Society,606,Contenders,2020,0,4,general,Middle
3445,2004,15,Fellow of the Royal Society,192,Contenders,2019,0,15,general,Young
3446,2011,9,MacArthur Fellowship,835,Contenders,2020,0,9,general,Young
3447,2012,0,Max Planck Medal,1150,Contenders,2012,1,0,physics,Middle
3448,1993,16,Fellow of the Royal Society,504,Contenders,2009,1,16,general,Middle
3449,1988,8,Shanti Swarup Bhatnagar Prize for Science and Technology,1347,Contenders,1996,1,8,general,Young
3450,1977,3,Max Planck Medal,480,Contenders,1980,1,3,physics,Middle
3451,1989,15,Fellow of the Royal Society,420,Contenders,2004,1,15,general,Young
3452,2009,11,Nobel Prize in Chemistry,44,Contenders,2020,0,11,chemistry,Senior
3453,1999,20,Fellow of the Royal Society,609,Contenders,2019,0,20,general,Middle
3454,1996,13,Fellow of the Royal Society,1193,Contenders,2009,1,13,general,Senior
3455,2004,16,Fellow of the Royal Society,914,Contenders,2020,0,16,general,Middle
3456,2008,12,Shanti Swarup Bhatnagar Prize for Science and Technology,181,Contenders,2020,0,12,general,Young
3457,2011,9,National Medal of Science,534,Contenders,2020,0,9,general,Senior
3458,2008,12,MacArthur Fellowship,9,Contenders,2020,0,12,general,Young
3459,1996,24,Nobel Prize in Physiology or Medicine,100,Contenders,2020,0,24,biology,Middle
3460,2003,3,Shanti Swarup Bhatnagar Prize for Science and Technology,1010,Contenders,2006,1,3,general,Middle
3461,2014,6,Nobel Prize in Physiology or Medicine,274,Contenders,2020,0,6,biology,Middle
3462,1998,20,Fellow of the Royal Society,1196,Contenders,2018,0,20,general,Middle
3463,2002,16,MacArthur Fellowship,481,Contenders,2018,0,16,general,Young
3464,1992,25,Fellow of the Royal Society,702,Contenders,2017,1,25,general,Middle
3465,1987,28,MacArthur Fellowship,266,Contenders,2015,1,28,general,Young
3466,2012,8,Fellow of the Royal Society,957,Contenders,2020,0,8,general,Young
3467,1969,31,Fellow of the Royal Society,699,Contenders,2000,1,31,general,Young
3468,2016,4,Shanti Swarup Bhatnagar Prize for Science and Technology,808,Contenders,2020,0,4,general,Young
3469,2017,3,Fellow of the Royal Society,71,Contenders,2020,0,3,general,Middle
3470,2015,4,Fellow of the Royal Society,707,Contenders,2019,0,4,general,Senior
3471,2015,5,Fellow of the Royal Society,718,Contenders,2020,0,5,general,Senior
3472,2018,2,Fellow of the Royal Society,395,Contenders,2020,0,2,general,Senior
3473,2009,11,MacArthur Fellowship,844,Contenders,2020,0,11,general,Young
3474,2017,2,Fellow of the Royal Society,715,Contenders,2019,0,2,general,NA
3475,1992,16,Fellow of the Royal Society,318,Contenders,2008,1,16,general,Young
3476,2016,3,Wolf Prize in Chemistry,1253,Contenders,2019,0,3,chemistry,Senior
3477,1996,24,MacArthur Fellowship,1169,Contenders,2020,0,24,general,Young
3478,2000,15,Shanti Swarup Bhatnagar Prize for Science and Technology,714,Contenders,2015,1,15,general,NA
3479,1993,13,Fellow of the Royal Society,110,Contenders,2006,1,13,general,Young
3480,2013,7,National Medal of Science,947,Contenders,2020,0,7,general,Senior
3481,1996,24,MacArthur Fellowship,301,Contenders,2020,0,24,general,Young
3482,1992,22,National Medal of Science,854,Contenders,2014,1,22,general,Senior
3483,1989,3,Turing Award,508,Contenders,1992,1,3,cs,Middle
3484,2003,9,Fellow of the Royal Society,503,Contenders,2012,1,9,general,Senior
3485,2005,7,Fellow of the Royal Society,1405,Contenders,2012,1,7,general,Middle
3486,1985,35,MacArthur Fellowship,912,Contenders,2020,0,35,general,Young
3487,1996,24,Fellow of the Royal Society,327,Contenders,2020,0,24,general,Middle
3488,2016,2,Shanti Swarup Bhatnagar Prize for Science and Technology,389,Contenders,2018,0,2,general,Young
3489,2003,17,Nobel Prize in Chemistry,1283,Contenders,2020,0,17,chemistry,Middle
3490,2010,9,Wolf Prize in Medicine,900,Contenders,2019,0,9,biology,Senior
3491,2016,4,Fellow of the Royal Society,606,Contenders,2020,0,4,general,Middle
3492,1989,30,Nobel Prize in Physics,70,Contenders,2019,0,30,physics,Senior
3493,1990,24,Fellow of the Royal Society,544,Contenders,2014,1,24,general,Middle
3494,1991,28,National Medal of Science,1372,Contenders,2019,0,28,general,Middle
3495,2011,9,Fellow of the Royal Society,19,Contenders,2020,0,9,general,NA
3496,2013,7,Shanti Swarup Bhatnagar Prize for Science and Technology,761,Contenders,2020,0,7,general,NA
3497,1994,25,Fellow of the Royal Society,896,Contenders,2019,0,25,general,Middle
3498,2007,13,Shanti Swarup Bhatnagar Prize for Science and Technology,350,Contenders,2020,0,13,general,NA
3499,2007,13,Shanti Swarup Bhatnagar Prize for Science and Technology,276,Contenders,2020,0,13,general,Young
3500,1973,40,Nobel Prize in Physics,215,Contenders,2013,1,40,physics,Young
3501,2016,4,Fellow of the Royal Society,930,Contenders,2020,0,4,general,Middle
3502,1990,8,National Medal of Science,563,Contenders,1998,1,8,general,Senior
3503,2014,5,Wolf Prize in Mathematics,459,Contenders,2019,0,5,mathematics,Senior
3504,1958,10,Fellow of the Royal Society,1399,Contenders,1968,1,10,general,Young
3505,2001,19,Fellow of the Royal Society,76,Contenders,2020,0,19,general,Middle
3506,2017,3,Fellow of the Royal Society,555,Contenders,2020,0,3,general,NA
3507,1999,12,MacArthur Fellowship,73,Contenders,2011,1,12,general,Young
3508,2010,10,MacArthur Fellowship,810,Contenders,2020,0,10,general,Young
3509,1988,31,Fellow of the Royal Society,342,Contenders,2019,0,31,general,Middle
3511,2015,5,Fellow of the Royal Society,1290,Contenders,2020,0,5,general,NA
3512,2016,4,Fellow of the Royal Society,608,Contenders,2020,0,4,general,NA
3513,1996,22,Shanti Swarup Bhatnagar Prize for Science and Technology,1250,Contenders,2018,0,22,general,Young
3514,1995,1,National Medal of Science,618,Contenders,1996,1,1,general,Senior
3515,2012,8,National Medal of Science,700,Contenders,2020,0,8,general,Senior
3516,2003,16,Fellow of the Royal Society,842,Contenders,2019,0,16,general,Middle
3518,1991,22,MacArthur Fellowship,32,Contenders,2013,1,22,general,Young
3519,2010,9,Fellow of the Royal Society,1062,Contenders,2019,0,9,general,Middle
3520,2009,8,Fellow of the Royal Society,438,Contenders,2017,1,8,general,Middle
3521,1971,36,Willard Gibbs Award,1464,Contenders,2007,1,36,chemistry,Middle
3522,2013,7,Fellow of the Royal Society,336,Contenders,2020,0,7,general,Middle
3523,1970,50,National Medal of Science,338,Contenders,2020,0,50,general,Middle
3524,1901,37,Fellow of the Royal Society,706,Contenders,1938,1,37,general,Young
3525,2013,6,Fellow of the Royal Society,1115,Contenders,2019,0,6,general,Middle
3526,2004,16,Fellow of the Royal Society,832,Contenders,2020,0,16,general,Middle
3527,1987,21,Wolf Prize in Medicine,6,Contenders,2008,1,21,biology,Middle
3528,2010,10,Fellow of the Royal Society,691,Contenders,2020,0,10,general,Middle
3529,1982,37,Fields Medal,1174,Contenders,2019,0,37,mathematics,Young
3530,2008,11,Fellow of the Royal Society,794,Contenders,2019,0,11,general,Middle
3531,2009,11,Fellow of the Royal Society,398,Contenders,2020,0,11,general,Middle
3532,2012,8,MacArthur Fellowship,365,Contenders,2020,0,8,general,Young
3534,2015,5,Fellow of the Royal Society,718,Contenders,2020,0,5,general,Senior
3535,2000,20,MacArthur Fellowship,381,Contenders,2020,0,20,general,Young
3536,1992,24,Nobel Prize in Physiology or Medicine,1034,Contenders,2016,1,24,biology,Senior
3537,2012,6,National Medal of Science,700,Contenders,2018,0,6,general,Senior
3538,1967,37,Shanti Swarup Bhatnagar Prize for Science and Technology,1393,Contenders,2004,1,37,general,Young
3539,1973,38,Nobel Prize in Physics,215,Contenders,2011,1,38,physics,Young
3540,2002,12,Shanti Swarup Bhatnagar Prize for Science and Technology,831,Contenders,2014,1,12,general,Young
3541,1992,27,Shanti Swarup Bhatnagar Prize for Science and Technology,974,Contenders,2019,0,27,general,Young
3542,2013,4,Fellow of the Royal Society,737,Contenders,2017,1,4,general,Young
3543,1978,39,Turing Award,423,Contenders,2017,1,39,cs,Young
3544,2009,11,Fellow of the Royal Society,1432,Contenders,2020,0,11,general,Middle
3545,1998,21,Nobel Prize in Physics,952,Contenders,2019,0,21,physics,Middle
3546,1990,29,MacArthur Fellowship,145,Contenders,2019,0,29,general,Young
3547,1999,20,Shanti Swarup Bhatnagar Prize for Science and Technology,450,Contenders,2019,0,20,general,Young
3548,2006,14,Fields Medal,483,Contenders,2020,0,14,mathematics,Young
3549,1981,38,Fellow of the Royal Society,349,Contenders,2019,0,38,general,Middle
3550,1994,26,Nobel Prize in Chemistry,1462,Contenders,2020,0,26,chemistry,Senior
3551,1987,30,MacArthur Fellowship,872,Contenders,2017,1,30,general,NA
3552,1956,16,Max Planck Medal,428,Contenders,1972,1,16,physics,Middle
3553,2005,6,National Medal of Science,419,Contenders,2011,1,6,general,Senior
3554,2010,10,Nobel Prize in Chemistry,1286,Contenders,2020,0,10,chemistry,Senior
3556,2006,14,Fellow of the Royal Society,247,Contenders,2020,0,14,general,NA
3557,2017,2,Fellow of the Royal Society,1173,Contenders,2019,0,2,general,Senior
3558,1988,32,MacArthur Fellowship,639,Contenders,2020,0,32,general,Young
3559,1977,43,Max Planck Medal,480,Contenders,2020,0,43,physics,Middle
3560,1990,17,National Medal of Science,494,Contenders,2007,1,17,general,Middle
3561,1980,0,Fellow of the Royal Society,523,Contenders,1980,1,0,general,Young
3562,2001,19,Nobel Prize in Physics,730,Contenders,2020,0,19,physics,Young
3563,1970,38,Fields Medal,779,Contenders,2008,1,38,mathematics,Young
3564,2005,14,Shanti Swarup Bhatnagar Prize for Science and Technology,663,Contenders,2019,0,14,general,Young
3565,2014,6,Breakthrough Prize in Life Sciences,876,Contenders,2020,0,6,biology,Senior
3566,1993,22,National Medal of Science,487,Contenders,2015,1,22,general,Senior
3567,2015,5,Nobel Prize in Chemistry,123,Contenders,2020,0,5,chemistry,Senior
3568,1998,22,Shanti Swarup Bhatnagar Prize for Science and Technology,889,Contenders,2020,0,22,general,Young
3569,1980,27,Marconi Prize,412,Contenders,2007,1,27,cs,Middle
3570,1981,19,Fellow of the Royal Society,1401,Contenders,2000,1,19,general,Young
3572,1994,25,Fellow of the Royal Society,52,Contenders,2019,0,25,general,Middle
3574,2012,5,Wolf Prize in Mathematics,262,Contenders,2017,1,5,mathematics,Senior
3575,1990,29,Nobel Prize in Physics,1412,Contenders,2019,0,29,physics,Middle
3576,2006,13,Shanti Swarup Bhatnagar Prize for Science and Technology,554,Contenders,2019,0,13,general,Young
3577,2010,10,Nobel Prize in Chemistry,224,Contenders,2020,0,10,chemistry,Senior
3578,1983,33,MacArthur Fellowship,748,Contenders,2016,1,33,general,Young
3579,2009,11,Fellow of the Royal Society,438,Contenders,2020,0,11,general,Middle
3580,1978,1,Shanti Swarup Bhatnagar Prize for Science and Technology,521,Contenders,1979,1,1,general,Young
3581,1991,29,Fellow of the Royal Society,178,Contenders,2020,0,29,general,Middle
3582,2017,3,Nobel Prize in Physiology or Medicine,1088,Contenders,2020,0,3,biology,Senior
3583,2004,16,Fellow of the Royal Society,832,Contenders,2020,0,16,general,Middle
3584,2014,6,Fellow of the Royal Society,41,Contenders,2020,0,6,general,Middle
3585,1991,25,MacArthur Fellowship,724,Contenders,2016,1,25,general,Young
3586,1989,28,MacArthur Fellowship,802,Contenders,2017,1,28,general,Young
3587,1965,43,National Medal of Science,1416,Contenders,2008,1,43,general,Young
3588,2004,14,Shanti Swarup Bhatnagar Prize for Science and Technology,956,Contenders,2018,0,14,general,Young
3589,2002,17,MacArthur Fellowship,28,Contenders,2019,0,17,general,Young
3590,1994,24,Shanti Swarup Bhatnagar Prize for Science and Technology,1071,Contenders,2018,0,24,general,Young
3591,1999,12,Fellow of the Royal Society,511,Contenders,2011,1,12,general,Middle
3592,2003,17,Fellow of the Royal Society,238,Contenders,2020,0,17,general,Middle
3593,2006,12,Nobel Prize in Physiology or Medicine,142,Contenders,2018,0,12,biology,Middle
3594,2016,4,Fellow of the Royal Society,803,Contenders,2020,0,4,general,NA
3595,1983,32,Shanti Swarup Bhatnagar Prize for Science and Technology,1428,Contenders,2015,1,32,general,Young
3596,2011,8,Fellow of the Royal Society,1369,Contenders,2019,0,8,general,Senior
3597,1986,20,Fellow of the Royal Society,99,Contenders,2006,1,20,general,Young
3598,1998,19,Fellow of the Royal Society,465,Contenders,2017,1,19,general,Middle
3599,2010,9,Shanti Swarup Bhatnagar Prize for Science and Technology,116,Contenders,2019,0,9,general,Young
3600,1995,24,Shanti Swarup Bhatnagar Prize for Science and Technology,473,Contenders,2019,0,24,general,Young
3601,1991,28,Fellow of the Royal Society,282,Contenders,2019,0,28,general,Young
3602,2003,8,National Medal of Science,77,Contenders,2011,1,8,general,Senior
3603,1999,13,Fellow of the Royal Society,1002,Contenders,2012,1,13,general,Senior
3604,2015,5,MacArthur Fellowship,1160,Contenders,2020,0,5,general,Young
3605,1987,20,National Medal of Science,245,Contenders,2007,1,20,general,Senior
3606,1964,0,National Medal of Science,1086,Contenders,1964,1,0,general,Middle
3607,1982,32,Shanti Swarup Bhatnagar Prize for Science and Technology,650,Contenders,2014,1,32,general,Young
3608,1986,16,Nobel Prize in Physiology or Medicine,160,Contenders,2002,1,16,biology,Senior
3609,2005,15,Fellow of the Royal Society,1079,Contenders,2020,0,15,general,Senior
3610,1978,32,Fellow of the Royal Society,1184,Contenders,2010,1,32,general,Middle
3612,2000,18,Nobel Prize in Chemistry,637,Contenders,2018,0,18,chemistry,Senior
3613,1995,24,Fellow of the Royal Society,602,Contenders,2019,0,24,general,Middle
3614,1978,30,Nobel Prize in Physiology or Medicine,180,Contenders,2008,1,30,biology,Middle
3615,1994,25,Fields Medal,340,Contenders,2019,0,25,mathematics,Young
3617,2004,16,Fellow of the Royal Society,1096,Contenders,2020,0,16,general,Middle
3618,2011,9,Fellow of the Royal Society,1180,Contenders,2020,0,9,general,Young
3620,2015,4,Fellow of the Royal Society,1097,Contenders,2019,0,4,general,NA
3621,1987,33,MacArthur Fellowship,464,Contenders,2020,0,33,general,Young
3622,2008,12,MacArthur Fellowship,432,Contenders,2020,0,12,general,Young
3623,1971,40,Fellow of the Royal Society,667,Contenders,2011,1,40,general,Young
3624,2014,6,Fellow of the Royal Society,1036,Contenders,2020,0,6,general,NA
3625,2006,10,Nobel Prize in Physics,678,Contenders,2016,1,10,physics,Middle
3626,2018,2,Fellow of the Royal Society,607,Contenders,2020,0,2,general,Senior
3627,2000,5,National Medal of Science,171,Contenders,2005,1,5,general,Senior
3628,2002,17,Shanti Swarup Bhatnagar Prize for Science and Technology,831,Contenders,2019,0,17,general,Young
3629,1996,22,Shanti Swarup Bhatnagar Prize for Science and Technology,838,Contenders,2018,0,22,general,Young
3630,1959,46,Nobel Prize in Physiology or Medicine,227,Contenders,2005,1,46,biology,Young
3631,1982,37,Wolf Prize in Medicine,1328,Contenders,2019,0,37,biology,Middle
3632,2017,2,Breakthrough Prize in Life Sciences,37,Contenders,2019,0,2,biology,Senior
3633,1991,10,MacArthur Fellowship,547,Contenders,2001,1,10,general,Young
3634,2014,6,Fields Medal,102,Contenders,2020,0,6,mathematics,Young
3635,2002,17,Fellow of the Royal Society,1152,Contenders,2019,0,17,general,Middle
3636,2008,11,Shanti Swarup Bhatnagar Prize for Science and Technology,567,Contenders,2019,0,11,general,Young
3637,1988,31,Fellow of the Royal Society,1021,Contenders,2019,0,31,general,Middle
3638,1998,21,National Medal of Science,22,Contenders,2019,0,21,general,Senior
3639,2014,6,Abel Prize,705,Contenders,2020,0,6,mathematics,Senior
3640,2000,17,Fellow of the Royal Society,194,Contenders,2017,1,17,general,Middle
3641,1986,21,Nobel Prize in Chemistry,402,Contenders,2007,1,21,chemistry,Middle
3642,2000,10,Fellow of the Royal Society,1102,Contenders,2010,1,10,general,Middle
3643,1981,39,Fellow of the Royal Society,891,Contenders,2020,0,39,general,Middle
3644,2007,12,Fellow of the Royal Society,114,Contenders,2019,0,12,general,Middle
3646,2005,14,Fellow of the Royal Society,917,Contenders,2019,0,14,general,Middle
3647,2012,7,MacArthur Fellowship,365,Contenders,2019,0,7,general,Young
3648,1974,37,Fellow of the Royal Society,312,Contenders,2011,1,37,general,Middle
3649,2010,10,Fellow of the Royal Society,691,Contenders,2020,0,10,general,Middle
3650,1964,9,Nobel Prize in Physics,1334,Contenders,1973,1,9,physics,Middle
3651,1985,34,MacArthur Fellowship,1191,Contenders,2019,0,34,general,Middle
3653,2014,6,Nobel Prize in Physics,1280,Contenders,2020,0,6,physics,Middle
3654,2000,19,MacArthur Fellowship,278,Contenders,2019,0,19,general,Young
3655,2008,12,Nobel Prize in Physiology or Medicine,397,Contenders,2020,0,12,biology,Senior
3656,2010,9,Wolf Prize in Medicine,900,Contenders,2019,0,9,biology,Senior
3657,2010,10,Fields Medal,543,Contenders,2020,0,10,mathematics,Young
3658,2011,9,MacArthur Fellowship,680,Contenders,2020,0,9,general,Young
3659,1965,12,Nobel Prize in Physiology or Medicine,182,Contenders,1977,1,12,biology,Senior
3660,2001,18,Shanti Swarup Bhatnagar Prize for Science and Technology,1317,Contenders,2019,0,18,general,Young
3661,1966,28,Fellow of the Royal Society,500,Contenders,1994,1,28,general,Middle
3662,2003,14,Fellow of the Royal Society,992,Contenders,2017,1,14,general,Middle
3663,1999,21,Fellow of the Royal Society,1002,Contenders,2020,0,21,general,Senior
3664,1997,19,Max Planck Medal,1258,Contenders,2016,1,19,physics,Senior
3665,1999,20,Shanti Swarup Bhatnagar Prize for Science and Technology,450,Contenders,2019,0,20,general,Young
3666,2009,0,Fellow of the Royal Society,1432,Contenders,2009,1,0,general,Middle
3667,2014,4,Nobel Prize in Chemistry,87,Contenders,2018,0,4,chemistry,Middle
3668,2014,6,Breakthrough Prize in Life Sciences,876,Contenders,2020,0,6,biology,Senior
3669,1986,13,Shanti Swarup Bhatnagar Prize for Science and Technology,1100,Contenders,1999,1,13,general,Young
3670,2001,19,Fellow of the Royal Society,1302,Contenders,2020,0,19,general,Middle
3671,1979,33,National Medal of Science,1151,Contenders,2012,1,33,general,Middle
3672,1992,15,Edison Medal,1074,Contenders,2007,1,15,cs,Middle
3673,2005,14,National Medal of Science,1039,Contenders,2019,0,14,general,Middle
3674,1990,8,Fellow of the Royal Society,1056,Contenders,1998,1,8,general,Young
3675,2016,4,Fellow of the Royal Society,268,Contenders,2020,0,4,general,Middle
3676,2002,18,Nobel Prize in Chemistry,1355,Contenders,2020,0,18,chemistry,Young
3677,2007,0,MacArthur Fellowship,81,Contenders,2007,1,0,general,Middle
3678,1967,26,Fellow of the Royal Society,1379,Contenders,1993,1,26,general,Young
3680,1957,7,Nobel Prize in Physiology or Medicine,1327,Contenders,1964,1,7,biology,Middle
3681,1993,24,Fellow of the Royal Society,826,Contenders,2017,1,24,general,NA
3682,1999,21,Fellow of the Royal Society,1390,Contenders,2020,0,21,general,Young
3683,1982,18,National Medal of Science,883,Contenders,2000,1,18,general,Senior
3684,1989,30,Fellow of the Royal Society,524,Contenders,2019,0,30,general,Young
3685,1964,35,Nobel Prize in Physics,1334,Contenders,1999,1,35,physics,Middle
3686,2018,2,Breakthrough Prize in Life Sciences,280,Contenders,2020,0,2,biology,Senior
3687,2009,11,Shanti Swarup Bhatnagar Prize for Science and Technology,431,Contenders,2020,0,11,general,Young
3688,1986,6,Shanti Swarup Bhatnagar Prize for Science and Technology,115,Contenders,1992,1,6,general,Young
3689,2011,7,Fellow of the Royal Society,820,Contenders,2018,0,7,general,Middle
3690,2008,12,Fellow of the Royal Society,560,Contenders,2020,0,12,general,Middle
3691,2013,7,Fellow of the Royal Society,59,Contenders,2020,0,7,general,Senior
3692,2007,13,Fellow of the Royal Society,436,Contenders,2020,0,13,general,Senior
3693,2009,10,Nobel Prize in Physiology or Medicine,231,Contenders,2019,0,10,biology,Middle
3694,1998,21,MacArthur Fellowship,83,Contenders,2019,0,21,general,Young
3696,1999,17,Copley Medal,785,Contenders,2016,1,17,general,Senior
3697,2014,6,Nobel Prize in Physiology or Medicine,274,Contenders,2020,0,6,biology,Middle
3698,1949,6,Lasker-DeBakey Clinical Medical Research Award,801,Contenders,1955,1,6,biology,Senior
3699,1994,25,Fellow of the Royal Society,1168,Contenders,2019,0,25,general,Middle
3700,2006,14,Shanti Swarup Bhatnagar Prize for Science and Technology,1166,Contenders,2020,0,14,general,Young
3701,2007,12,Fellow of the Royal Society,47,Contenders,2019,0,12,general,Middle
3702,2005,15,Fellow of the Royal Society,878,Contenders,2020,0,15,general,Senior
3703,2013,7,Breakthrough Prize in Life Sciences,759,Contenders,2020,0,7,biology,Middle
3704,1964,47,National Medal of Science,701,Contenders,2011,1,47,general,Middle
3705,2010,10,Wolf Prize in Medicine,900,Contenders,2020,0,10,biology,Senior
3706,2002,17,Fellow of the Royal Society,616,Contenders,2019,0,17,general,Middle
3707,1983,2,Turing Award,1018,Contenders,1985,1,2,cs,Young
3708,2018,2,Fellow of the Royal Society,516,Contenders,2020,0,2,general,Middle
3709,2012,8,Shanti Swarup Bhatnagar Prize for Science and Technology,1013,Contenders,2020,0,8,general,Senior
3710,1993,20,MacArthur Fellowship,1014,Contenders,2013,1,20,general,Young
3711,2015,5,Nobel Prize in Chemistry,1244,Contenders,2020,0,5,chemistry,Senior
3712,2017,3,Nobel Prize in Physics,188,Contenders,2020,0,3,physics,Senior
3713,1984,24,MacArthur Fellowship,166,Contenders,2008,1,24,general,Middle
3714,2014,5,Fellow of the Royal Society,255,Contenders,2019,0,5,general,Senior
3715,2001,3,National Medal of Science,339,Contenders,2004,1,3,general,Senior
3716,1993,26,Fellow of the Royal Society,441,Contenders,2019,0,26,general,Young
3717,2000,19,Nobel Prize in Physics,630,Contenders,2019,0,19,physics,Senior
3718,1971,22,Fellow of the Royal Society,1230,Contenders,1993,1,22,general,Young
3719,2000,17,Fellow of the Royal Society,294,Contenders,2017,1,17,general,Middle
3720,2017,2,Nobel Prize in Physiology or Medicine,1442,Contenders,2019,0,2,biology,Senior
3721,1998,20,Fellow of the Royal Society,492,Contenders,2018,0,20,general,Middle
3722,1990,30,Fellow of the Royal Society,778,Contenders,2020,0,30,general,Middle
3723,2017,3,Nobel Prize in Physics,1252,Contenders,2020,0,3,physics,Senior
3724,2001,19,Nobel Prize in Physics,323,Contenders,2020,0,19,physics,Middle
3725,2001,18,Fellow of the Royal Society,256,Contenders,2019,0,18,general,Middle
3726,1954,12,Fellow of the Royal Society,14,Contenders,1966,1,12,general,Middle
3727,1992,27,Fellow of the Royal Society,710,Contenders,2019,0,27,general,Middle
3728,1995,25,Nobel Prize in Physiology or Medicine,157,Contenders,2020,0,25,biology,Middle
3729,1974,46,Fellow of the Royal Society,220,Contenders,2020,0,46,general,Young
3730,1986,34,MacArthur Fellowship,973,Contenders,2020,0,34,general,Middle
3731,1987,30,MacArthur Fellowship,1133,Contenders,2017,1,30,general,Middle
3733,2010,10,Shanti Swarup Bhatnagar Prize for Science and Technology,634,Contenders,2020,0,10,general,Young
3735,2007,12,Willard Gibbs Award,435,Contenders,2019,0,12,chemistry,Middle
3736,1988,28,MacArthur Fellowship,1404,Contenders,2016,1,28,general,Middle
3737,2016,4,Nobel Prize in Chemistry,185,Contenders,2020,0,4,chemistry,Senior
3738,2003,17,Fellow of the Royal Society,238,Contenders,2020,0,17,general,Middle
3739,2015,4,Fellow of the Royal Society,363,Contenders,2019,0,4,general,NA
3740,1992,8,Edison Medal,1074,Contenders,2000,1,8,cs,Middle
3741,1996,24,Shanti Swarup Bhatnagar Prize for Science and Technology,421,Contenders,2020,0,24,general,Young
3742,1989,31,Fellow of the Royal Society,1061,Contenders,2020,0,31,general,Middle
3744,1980,34,Nobel Prize in Chemistry,1178,Contenders,2014,1,34,chemistry,Middle
3745,1978,28,Shanti Swarup Bhatnagar Prize for Science and Technology,797,Contenders,2006,1,28,general,Young
3746,2015,5,Breakthrough Prize in Life Sciences,179,Contenders,2020,0,5,biology,Young
3747,1979,41,Fellow of the Royal Society,615,Contenders,2020,0,41,general,Young
3748,2014,6,Fellow of the Royal Society,425,Contenders,2020,0,6,general,Middle
3749,2007,13,SASTRA Ramanujan Prize,1123,Contenders,2020,0,13,mathematics,Young
3750,1974,41,Shanti Swarup Bhatnagar Prize for Science and Technology,1299,Contenders,2015,1,41,general,Young
3751,1981,32,Shanti Swarup Bhatnagar Prize for Science and Technology,708,Contenders,2013,1,32,general,Young
3752,1969,37,Nobel Prize in Physiology or Medicine,499,Contenders,2006,1,37,biology,Middle
3753,2013,6,Shanti Swarup Bhatnagar Prize for Science and Technology,761,Contenders,2019,0,6,general,NA
3754,1978,34,Turing Award,423,Contenders,2012,1,34,cs,Young
3755,2011,8,National Medal of Science,1305,Contenders,2019,0,8,general,Senior
3756,2015,5,Shanti Swarup Bhatnagar Prize for Science and Technology,305,Contenders,2020,0,5,general,Young
3757,2006,12,Fellow of the Royal Society,1167,Contenders,2018,0,12,general,Middle
3758,1982,34,Fields Medal,661,Contenders,2016,1,34,mathematics,Young
3759,1994,25,Fellow of the Royal Society,408,Contenders,2019,0,25,general,Young
3760,1989,20,Willard Gibbs Award,899,Contenders,2009,1,20,chemistry,Senior
3761,2013,7,Fellow of the Royal Society,964,Contenders,2020,0,7,general,Middle
3762,2004,14,Wolf Prize in Physics,360,Contenders,2018,0,14,physics,Senior
3763,1998,20,Fellow of the Royal Society,474,Contenders,2018,0,20,general,Young
3764,2016,4,Fellow of the Royal Society,532,Contenders,2020,0,4,general,Young
3765,2001,12,Fellow of the Royal Society,256,Contenders,2013,1,12,general,Middle
3766,1998,22,MacArthur Fellowship,83,Contenders,2020,0,22,general,Young
3767,1931,76,Nobel Prize in Physiology or Medicine,210,Contenders,2007,1,76,biology,Middle
3768,1974,25,Fellow of the Royal Society,1382,Contenders,1999,1,25,general,Middle
3769,2007,12,Fellow of the Royal Society,380,Contenders,2019,0,12,general,Middle
3770,2009,11,Fellow of the Royal Society,429,Contenders,2020,0,11,general,Middle
3771,2006,14,Wolf Prize in Physics,1335,Contenders,2020,0,14,physics,Senior
3772,1972,33,Fellow of the Royal Society,1186,Contenders,2005,1,33,general,Young
3773,1990,30,Fellow of the Royal Society,544,Contenders,2020,0,30,general,Middle
3774,2017,2,Fellow of the Royal Society,1275,Contenders,2019,0,2,general,Middle
3775,2001,14,MacArthur Fellowship,1119,Contenders,2015,1,14,general,Young
3776,1987,12,Fellow of the Royal Society,657,Contenders,1999,1,12,general,Senior
3777,2015,2,Nobel Prize in Chemistry,1244,Contenders,2017,1,2,chemistry,Senior
3778,1972,37,Lasker-DeBakey Clinical Medical Research Award,199,Contenders,2009,1,37,biology,Middle
3779,1970,39,Fellow of the Royal Society,1081,Contenders,2009,1,39,general,Middle
3780,2009,11,MacArthur Fellowship,485,Contenders,2020,0,11,general,Middle
3783,2008,11,Fellow of the Royal Society,149,Contenders,2019,0,11,general,NA
3784,1995,25,Fellow of the Royal Society,1257,Contenders,2020,0,25,general,Young
3786,2015,5,Fellow of the Royal Society,322,Contenders,2020,0,5,general,NA
3787,1953,35,Nobel Prize in Physiology or Medicine,198,Contenders,1988,1,35,biology,Middle
3788,2018,2,Fellow of the Royal Society,601,Contenders,2020,0,2,general,Middle
3790,2009,3,National Medal of Science,173,Contenders,2012,1,3,general,Senior
3791,1982,37,Lasker-DeBakey Clinical Medical Research Award,592,Contenders,2019,0,37,biology,Middle
3792,2016,1,Fellow of the Royal Society,137,Contenders,2017,1,1,general,NA
3793,2003,15,National Medal of Science,1164,Contenders,2018,0,15,general,Senior
3794,2010,10,National Medal of Science,1284,Contenders,2020,0,10,general,Senior
3795,1983,31,Fellow of the Royal Society,542,Contenders,2014,1,31,general,Middle
3796,2006,9,Fellow of the Royal Society,1139,Contenders,2015,1,9,general,Middle
3797,1978,27,Fellow of the Royal Society,1411,Contenders,2005,1,27,general,Young
3798,2016,4,Fellow of the Royal Society,96,Contenders,2020,0,4,general,Middle
3799,2004,13,Nobel Prize in Chemistry,187,Contenders,2017,1,13,chemistry,Middle
3800,2017,3,Fellow of the Royal Society,555,Contenders,2020,0,3,general,NA
3801,2000,20,Fellow of the Royal Society,1102,Contenders,2020,0,20,general,Middle
3802,2005,15,Willard Gibbs Award,1035,Contenders,2020,0,15,chemistry,Senior
3803,1972,11,Lasker-DeBakey Clinical Medical Research Award,199,Contenders,1983,1,11,biology,Middle
3804,2014,2,Fields Medal,585,Contenders,2016,1,2,mathematics,Young
3805,1989,26,Fellow of the Royal Society,531,Contenders,2015,1,26,general,Young
3806,2009,6,Fellow of the Royal Society,1089,Contenders,2015,1,6,general,Middle
3808,2013,7,Fellow of the Royal Society,1410,Contenders,2020,0,7,general,Middle
3809,2010,9,Wolf Prize in Physics,1318,Contenders,2019,0,9,physics,Senior
3810,1990,21,Shanti Swarup Bhatnagar Prize for Science and Technology,67,Contenders,2011,1,21,general,Young
3811,1997,22,Max Planck Medal,1258,Contenders,2019,0,22,physics,Senior
3812,1994,25,Fellow of the Royal Society,896,Contenders,2019,0,25,general,Middle
3813,2009,10,Shanti Swarup Bhatnagar Prize for Science and Technology,1449,Contenders,2019,0,10,general,NA
3814,2001,19,National Medal of Science,482,Contenders,2020,0,19,general,Senior
3815,1999,21,Fellow of the Royal Society,852,Contenders,2020,0,21,general,Middle
3816,1994,18,Fellow of the Royal Society,293,Contenders,2012,1,18,general,Young
3817,1966,43,Lasker-DeBakey Clinical Medical Research Award,982,Contenders,2009,1,43,biology,Senior
3818,1971,14,Fellow of the Royal Society,242,Contenders,1985,1,14,general,Middle
3819,2015,5,Shanti Swarup Bhatnagar Prize for Science and Technology,305,Contenders,2020,0,5,general,Young
3820,1975,17,Fellow of the Royal Society,1217,Contenders,1992,1,17,general,Senior
3821,2000,20,Fellow of the Royal Society,720,Contenders,2020,0,20,general,NA
3823,2013,3,Fellow of the Royal Society,486,Contenders,2016,1,3,general,Middle
3824,1989,30,Nobel Prize in Physiology or Medicine,155,Contenders,2019,0,30,biology,Middle
3825,1989,30,Nobel Prize in Physiology or Medicine,1276,Contenders,2019,0,30,biology,Middle
3826,1993,26,Nobel Prize in Physiology or Medicine,776,Contenders,2019,0,26,biology,Middle
3827,2007,9,MacArthur Fellowship,675,Contenders,2016,1,9,general,NA
3828,2014,6,Fellow of the Royal Society,204,Contenders,2020,0,6,general,Middle
3830,1998,20,MacArthur Fellowship,1157,Contenders,2018,0,20,general,Middle
3831,2006,14,Fellow of the Royal Society,847,Contenders,2020,0,14,general,NA
3832,2017,3,Fellow of the Royal Society,439,Contenders,2020,0,3,general,Senior
3833,1997,23,Fellow of the Royal Society,451,Contenders,2020,0,23,general,Middle
3834,2001,19,National Medal of Science,1310,Contenders,2020,0,19,general,Senior
3835,2004,16,MacArthur Fellowship,1038,Contenders,2020,0,16,general,Young
3836,2006,13,Marconi Prize,757,Contenders,2019,0,13,cs,Middle
3837,1992,22,Fellow of the Royal Society,1070,Contenders,2014,1,22,general,Senior
3838,1989,15,Nobel Prize in Chemistry,1130,Contenders,2004,1,15,chemistry,Middle
3839,2017,3,Fellow of the Royal Society,1236,Contenders,2020,0,3,general,Senior
3840,2017,2,Fellow of the Royal Society,1042,Contenders,2019,0,2,general,NA
3841,2014,6,Wolf Prize in Medicine,296,Contenders,2020,0,6,biology,Senior
3842,2011,8,Fellow of the Royal Society,820,Contenders,2019,0,8,general,Middle
3843,2015,5,Wolf Prize in Medicine,463,Contenders,2020,0,5,biology,Senior
3844,1963,53,Lasker-DeBakey Clinical Medical Research Award,1321,Contenders,2016,1,53,biology,Senior
3845,1990,29,Fellow of the Royal Society,1056,Contenders,2019,0,29,general,Young
3846,1951,9,Hughes Medal,1324,Contenders,1960,1,9,physics,Middle
3847,1988,12,Nobel Prize in Chemistry,823,Contenders,2000,1,12,chemistry,Young
3849,2000,18,Shanti Swarup Bhatnagar Prize for Science and Technology,324,Contenders,2018,0,18,general,Young
3850,1996,6,Shanti Swarup Bhatnagar Prize for Science and Technology,383,Contenders,2002,1,6,general,Young
3851,1990,30,Lyell Medal,1331,Contenders,2020,0,30,geography,Middle
3852,2002,16,MacArthur Fellowship,28,Contenders,2018,0,16,general,Young
3853,2014,6,Fellow of the Royal Society,410,Contenders,2020,0,6,general,Middle
3854,1980,12,Fellow of the Royal Society,523,Contenders,1992,1,12,general,Young
3855,2014,6,Fields Medal,585,Contenders,2020,0,6,mathematics,Young
3856,2011,9,Shanti Swarup Bhatnagar Prize for Science and Technology,1028,Contenders,2020,0,9,general,Young
3857,2005,13,MacArthur Fellowship,868,Contenders,2018,0,13,general,Young
3858,1990,1,Nobel Prize in Physiology or Medicine,1229,Contenders,1991,1,1,biology,Senior
3859,1997,17,National Medal of Science,1453,Contenders,2014,1,17,general,Senior
3860,1983,36,MacArthur Fellowship,299,Contenders,2019,0,36,general,Young
3861,2014,6,Fellow of the Royal Society,989,Contenders,2020,0,6,general,Senior
3862,1987,33,MacArthur Fellowship,151,Contenders,2020,0,33,general,Young
3863,1979,8,Fellow of the Royal Society,393,Contenders,1987,1,8,general,Middle
3864,1967,3,Fellow of the Royal Society,1423,Contenders,1970,1,3,general,Young
3865,2004,16,Fellow of the Royal Society,1011,Contenders,2020,0,16,general,Middle
3866,2001,19,Fellow of the Royal Society,496,Contenders,2020,0,19,general,Middle
3867,2006,14,Wolf Prize in Physics,1335,Contenders,2020,0,14,physics,Senior
3868,1995,21,National Medal of Science,1211,Contenders,2016,1,21,general,Middle
3869,2008,11,Fellow of the Royal Society,725,Contenders,2019,0,11,general,Middle
3870,1975,25,Fellow of the Royal Society,1217,Contenders,2000,1,25,general,Senior
3871,1983,19,Fellow of the Royal Society,693,Contenders,2002,1,19,general,Middle
3872,1996,9,MacArthur Fellowship,1169,Contenders,2005,1,9,general,Young
3873,1989,2,National Medal of Science,132,Contenders,1991,1,2,general,Senior
3874,1987,32,MacArthur Fellowship,613,Contenders,2019,0,32,general,Middle
3875,2014,5,Fields Medal,102,Contenders,2019,0,5,mathematics,Young
3876,2005,15,Shanti Swarup Bhatnagar Prize for Science and Technology,456,Contenders,2020,0,15,general,Young
3877,2017,3,Breakthrough Prize in Life Sciences,68,Contenders,2020,0,3,biology,Senior
3878,2018,2,Breakthrough Prize in Life Sciences,280,Contenders,2020,0,2,biology,Senior
3879,1999,20,Shanti Swarup Bhatnagar Prize for Science and Technology,302,Contenders,2019,0,20,general,Young
3880,1983,20,MacArthur Fellowship,117,Contenders,2003,1,20,general,Young
3881,2000,5,Shanti Swarup Bhatnagar Prize for Science and Technology,324,Contenders,2005,1,5,general,Young
3882,1944,48,Fellow of the Royal Society,669,Contenders,1992,1,48,general,Middle
3883,1978,42,Fields Medal,38,Contenders,2020,0,42,mathematics,Young
3884,2012,8,Wolf Prize in Mathematics,124,Contenders,2020,0,8,mathematics,Senior
3885,1972,47,Fellow of the Royal Society,733,Contenders,2019,0,47,general,Young
3886,2007,13,Fellow of the Royal Society,47,Contenders,2020,0,13,general,Middle
3887,2014,6,Fellow of the Royal Society,255,Contenders,2020,0,6,general,Senior
3888,2008,12,National Medal of Science,858,Contenders,2020,0,12,general,Senior
3889,2011,9,Fellow of the Royal Society,1407,Contenders,2020,0,9,general,Senior
3890,1983,20,MacArthur Fellowship,871,Contenders,2003,1,20,general,Middle
3891,1991,29,Fellow of the Royal Society,510,Contenders,2020,0,29,general,Senior
3892,2010,6,Shanti Swarup Bhatnagar Prize for Science and Technology,955,Contenders,2016,1,6,general,NA
3893,2000,20,MacArthur Fellowship,1273,Contenders,2020,0,20,general,Young
3894,2007,13,Fellow of the Royal Society,953,Contenders,2020,0,13,general,Senior
3895,1996,23,MacArthur Fellowship,301,Contenders,2019,0,23,general,Young
3896,2001,19,National Medal of Science,694,Contenders,2020,0,19,general,Senior
3897,2003,16,Shanti Swarup Bhatnagar Prize for Science and Technology,938,Contenders,2019,0,16,general,Young
3898,1983,3,Wolf Prize in Chemistry,1008,Contenders,1986,1,3,chemistry,Middle
3899,2010,10,Fellow of the Royal Society,271,Contenders,2020,0,10,general,Middle
3900,1968,29,Fellow of the Royal Society,1245,Contenders,1997,1,29,general,Middle
3901,2012,8,Fellow of the Royal Society,1068,Contenders,2020,0,8,general,Senior
3902,2000,10,MacArthur Fellowship,1273,Contenders,2010,1,10,general,Young
3903,1974,12,Fields Medal,362,Contenders,1986,1,12,mathematics,Young
3904,1984,36,Fellow of the Royal Society,583,Contenders,2020,0,36,general,Middle
3905,1988,23,Shanti Swarup Bhatnagar Prize for Science and Technology,922,Contenders,2011,1,23,general,Young
3906,1958,22,Nobel Prize in Physiology or Medicine,909,Contenders,1980,1,22,biology,Middle
3907,1970,19,Nobel Prize in Physics,1251,Contenders,1989,1,19,physics,Senior
3908,1991,23,MacArthur Fellowship,202,Contenders,2014,1,23,general,NA
3909,1990,2,Wolf Prize in Physics,93,Contenders,1992,1,2,physics,Middle
3910,2008,12,National Medal of Science,916,Contenders,2020,0,12,general,Senior
3911,2007,12,Fellow of the Royal Society,436,Contenders,2019,0,12,general,Senior
3912,1986,10,National Medal of Science,396,Contenders,1996,1,10,general,Young
3914,1991,17,Fellow of the Royal Society,510,Contenders,2008,1,17,general,Senior
3915,1990,28,MacArthur Fellowship,156,Contenders,2018,0,28,general,Middle
3916,2015,5,Fellow of the Royal Society,1293,Contenders,2020,0,5,general,Senior
3917,1999,10,Fellow of the Royal Society,300,Contenders,2009,1,10,general,Middle
3918,2014,6,Fellow of the Royal Society,53,Contenders,2020,0,6,general,Middle
3919,1983,6,National Medal of Science,943,Contenders,1989,1,6,general,Young
3920,2006,13,Shanti Swarup Bhatnagar Prize for Science and Technology,554,Contenders,2019,0,13,general,Young
3921,2006,12,National Medal of Science,665,Contenders,2018,0,12,general,Senior
3922,2001,16,Wolf Prize in Medicine,793,Contenders,2017,1,16,biology,Middle
3923,2000,20,Nobel Prize in Physics,630,Contenders,2020,0,20,physics,Senior
3924,1999,16,Fellow of the Royal Society,101,Contenders,2015,1,16,general,Middle
3925,1993,13,MacArthur Fellowship,1014,Contenders,2006,1,13,general,Young
3927,1999,21,Copley Medal,785,Contenders,2020,0,21,general,Senior
3928,2002,17,Fellow of the Royal Society,225,Contenders,2019,0,17,general,Middle
3929,1991,13,Fellow of the Royal Society,394,Contenders,2004,1,13,general,Middle
3931,2007,13,Bigsby Medal,211,Contenders,2020,0,13,geography,Young
3932,1986,33,Fellow of the Royal Society,1392,Contenders,2019,0,33,general,Young
3933,1994,24,Fellow of the Royal Society,1064,Contenders,2018,0,24,general,Young
3934,1984,17,Shanti Swarup Bhatnagar Prize for Science and Technology,1292,Contenders,2001,1,17,general,Young
3935,2001,10,Wolf Prize in Medicine,793,Contenders,2011,1,10,biology,Middle
3936,1963,13,Lasker-DeBakey Clinical Medical Research Award,1321,Contenders,1976,1,13,biology,Senior
3937,2007,13,Shanti Swarup Bhatnagar Prize for Science and Technology,471,Contenders,2020,0,13,general,Young
3938,2004,15,Fellow of the Royal Society,832,Contenders,2019,0,15,general,Middle
3939,1984,35,MacArthur Fellowship,1402,Contenders,2019,0,35,general,Young
3941,2007,9,National Medal of Science,1172,Contenders,2016,1,9,general,Senior
3942,1992,27,Fellow of the Royal Society,1046,Contenders,2019,0,27,general,Middle
3943,1984,35,Fellow of the Royal Society,1126,Contenders,2019,0,35,general,Young
3944,2011,9,Wolf Prize in Medicine,784,Contenders,2020,0,9,biology,Middle
3945,1987,32,Fellow of the Royal Society,183,Contenders,2019,0,32,general,Middle
3946,1998,19,Fellow of the Royal Society,915,Contenders,2017,1,19,general,Middle
3947,2016,3,Fellow of the Royal Society,317,Contenders,2019,0,3,general,Senior
3948,2008,12,MacArthur Fellowship,233,Contenders,2020,0,12,general,Young
3949,2007,12,Fellow of the Royal Society,558,Contenders,2019,0,12,general,Middle
3950,1966,2,Shanti Swarup Bhatnagar Prize for Science and Technology,713,Contenders,1968,1,2,general,Young
3951,1987,22,MacArthur Fellowship,872,Contenders,2009,1,22,general,NA
3952,2001,19,Max Planck Medal,918,Contenders,2020,0,19,physics,Middle
3953,2004,16,Fellow of the Royal Society,1219,Contenders,2020,0,16,general,Middle
3954,2006,14,Fellow of the Royal Society,1167,Contenders,2020,0,14,general,Middle
3955,2007,13,Fellow of the Royal Society,927,Contenders,2020,0,13,general,Middle
3956,2015,5,Fellow of the Royal Society,43,Contenders,2020,0,5,general,Middle
3957,2011,9,Fellow of the Royal Society,19,Contenders,2020,0,9,general,NA
3959,1996,3,Nobel Prize in Physics,1132,Contenders,1999,1,3,physics,Senior
3960,1994,22,Fellow of the Royal Society,249,Contenders,2016,1,22,general,Young
3961,1992,23,MacArthur Fellowship,908,Contenders,2015,1,23,general,Middle
3962,1996,22,MacArthur Fellowship,1169,Contenders,2018,0,22,general,Young
3963,2007,13,Fellow of the Royal Society,558,Contenders,2020,0,13,general,Middle
3964,1974,32,Fellow of the Royal Society,1272,Contenders,2006,1,32,general,Middle
3965,2004,2,Nobel Prize in Chemistry,1341,Contenders,2006,1,2,chemistry,Senior
3966,2016,4,SASTRA Ramanujan Prize,50,Contenders,2020,0,4,mathematics,Young
3968,1986,34,MacArthur Fellowship,950,Contenders,2020,0,34,general,Young
3969,2018,2,Breakthrough Prize in Life Sciences,280,Contenders,2020,0,2,biology,Senior
3970,2010,9,Willard Gibbs Award,131,Contenders,2019,0,9,chemistry,Senior
3971,1992,26,National Medal of Science,662,Contenders,2018,0,26,general,Senior
3972,1999,10,Shanti Swarup Bhatnagar Prize for Science and Technology,1090,Contenders,2009,1,10,general,Young
3973,1987,24,National Medal of Science,755,Contenders,2011,1,24,general,Senior
3974,2017,3,Fellow of the Royal Society,358,Contenders,2020,0,3,general,Senior
3975,1989,14,National Medal of Science,112,Contenders,2003,1,14,general,Senior
3976,2007,13,Fellow of the Royal Society,114,Contenders,2020,0,13,general,Middle
3977,1964,42,Fellow of the Royal Society,1389,Contenders,2006,1,42,general,Young
3978,2017,2,Nobel Prize in Physiology or Medicine,647,Contenders,2019,0,2,biology,Senior
3979,1997,20,Lasker-DeBakey Clinical Medical Research Award,598,Contenders,2017,1,20,biology,Middle
3981,1968,39,Fellow of the Royal Society,1339,Contenders,2007,1,39,general,Young
3982,2018,2,Breakthrough Prize in Life Sciences,590,Contenders,2020,0,2,biology,Senior
3983,2001,18,Fellow of the Royal Society,1144,Contenders,2019,0,18,general,Senior
3984,1991,24,Wolf Prize in Chemistry,870,Contenders,2015,1,24,chemistry,Middle
3985,1959,47,Nobel Prize in Physiology or Medicine,227,Contenders,2006,1,47,biology,Young
3986,2002,18,Fellow of the Royal Society,546,Contenders,2020,0,18,general,Middle
3987,1987,33,Nobel Prize in Physics,1084,Contenders,2020,0,33,physics,Young
3988,1980,26,Nobel Prize in Physics,879,Contenders,2006,1,26,physics,Middle
3989,1994,11,Wollaston Medal,780,Contenders,2005,1,11,geography,Middle
3990,1982,24,Nobel Prize in Physiology or Medicine,197,Contenders,2006,1,24,biology,Middle
3991,1994,12,Nobel Prize in Physiology or Medicine,1344,Contenders,2006,1,12,biology,Middle
3992,2004,16,Nobel Prize in Chemistry,187,Contenders,2020,0,16,chemistry,Middle
3993,2002,12,Nobel Prize in Chemistry,1355,Contenders,2014,1,12,chemistry,Young
3994,2001,9,Fellow of the Royal Society,749,Contenders,2010,1,9,general,Middle
3995,2004,11,Fellow of the Royal Society,1117,Contenders,2015,1,11,general,Senior
3996,2010,8,Shanti Swarup Bhatnagar Prize for Science and Technology,265,Contenders,2018,0,8,general,Young
3997,1997,22,Fellow of the Royal Society,611,Contenders,2019,0,22,general,Middle
3998,2005,14,Fellow of the Royal Society,656,Contenders,2019,0,14,general,Middle
3999,2004,16,Shanti Swarup Bhatnagar Prize for Science and Technology,584,Contenders,2020,0,16,general,Young
4000,2012,0,National Medal of Science,1077,Contenders,2012,1,0,general,Senior
4001,1987,32,MacArthur Fellowship,313,Contenders,2019,0,32,general,Young
4002,1996,21,Fellow of the Royal Society,1417,Contenders,2017,1,21,general,Young
4003,1984,36,MacArthur Fellowship,1383,Contenders,2020,0,36,general,Young
4004,2010,8,National Medal of Science,407,Contenders,2018,0,8,general,Senior
4005,1990,4,Lyell Medal,1331,Contenders,1994,1,4,geography,Middle
4007,2016,4,Fellow of the Royal Society,906,Contenders,2020,0,4,general,Middle
4008,2014,6,Breakthrough Prize in Life Sciences,876,Contenders,2020,0,6,biology,Senior
4009,2010,9,MacArthur Fellowship,1421,Contenders,2019,0,9,general,Young
4010,1999,20,Shanti Swarup Bhatnagar Prize for Science and Technology,450,Contenders,2019,0,20,general,Young
4011,1980,20,Fellow of the Royal Society,1375,Contenders,2000,1,20,general,Young
4012,2011,9,MacArthur Fellowship,771,Contenders,2020,0,9,general,Young
4013,2017,3,Fellow of the Royal Society,320,Contenders,2020,0,3,general,Middle
4014,1984,28,Turing Award,1224,Contenders,2012,1,28,cs,Middle
4015,1986,34,National Medal of Science,396,Contenders,2020,0,34,general,Young
4016,1986,6,Wolf Prize in Medicine,1408,Contenders,1992,1,6,biology,Senior
4017,1992,14,National Medal of Science,854,Contenders,2006,1,14,general,Senior
4018,1985,34,MacArthur Fellowship,1118,Contenders,2019,0,34,general,Middle
4019,1985,35,Shanti Swarup Bhatnagar Prize for Science and Technology,961,Contenders,2020,0,35,general,Young
4020,1972,43,Shanti Swarup Bhatnagar Prize for Science and Technology,798,Contenders,2015,1,43,general,Young
4021,2006,14,Nobel Prize in Chemistry,60,Contenders,2020,0,14,chemistry,Middle
4022,1993,27,Fellow of the Royal Society,441,Contenders,2020,0,27,general,Young
4023,1983,13,Fellow of the Royal Society,525,Contenders,1996,1,13,general,Middle
4024,2017,3,Fellow of the Royal Society,963,Contenders,2020,0,3,general,Senior
4025,1978,42,Shanti Swarup Bhatnagar Prize for Science and Technology,797,Contenders,2020,0,42,general,Young
4026,1987,30,Fellow of the Royal Society,1185,Contenders,2017,1,30,general,Young
4027,1989,31,MacArthur Fellowship,411,Contenders,2020,0,31,general,Middle
4028,1990,30,MacArthur Fellowship,333,Contenders,2020,0,30,general,Middle
4029,2007,13,Copley Medal,1121,Contenders,2020,0,13,general,Senior
4030,2014,6,Fellow of the Royal Society,53,Contenders,2020,0,6,general,Middle
4031,1982,0,Lasker-DeBakey Clinical Medical Research Award,378,Contenders,1982,1,0,biology,Middle
4032,2017,3,Fellow of the Royal Society,866,Contenders,2020,0,3,general,Middle
4033,1984,35,MacArthur Fellowship,998,Contenders,2019,0,35,general,Young
4034,1990,2,MacArthur Fellowship,1181,Contenders,1992,1,2,general,Senior
4035,1955,54,Nobel Prize in Chemistry,82,Contenders,2009,1,54,chemistry,Middle
4036,1974,35,National Medal of Science,162,Contenders,2009,1,35,general,Senior
4037,1946,6,Nobel Prize in Chemistry,1381,Contenders,1952,1,6,chemistry,Middle
4038,2010,10,MacArthur Fellowship,1047,Contenders,2020,0,10,general,Young
4039,2015,5,Fellow of the Royal Society,330,Contenders,2020,0,5,general,Middle
4040,1991,15,Fellow of the Royal Society,980,Contenders,2006,1,15,general,Young
4041,2013,7,Fellow of the Royal Society,737,Contenders,2020,0,7,general,Young
4042,2009,11,Shanti Swarup Bhatnagar Prize for Science and Technology,431,Contenders,2020,0,11,general,Young
4043,1989,30,Nobel Prize in Physiology or Medicine,1276,Contenders,2019,0,30,biology,Middle
4044,2014,6,Nobel Prize in Physiology or Medicine,905,Contenders,2020,0,6,biology,Senior
4045,2011,8,Shanti Swarup Bhatnagar Prize for Science and Technology,260,Contenders,2019,0,8,general,Young
4046,2005,8,Fellow of the Royal Society,878,Contenders,2013,1,8,general,Senior
4047,2011,8,MacArthur Fellowship,680,Contenders,2019,0,8,general,Young
4048,1999,21,MacArthur Fellowship,719,Contenders,2020,0,21,general,NA
4049,1993,27,Fellow of the Royal Society,361,Contenders,2020,0,27,general,Middle
4050,1997,23,Fellow of the Royal Society,118,Contenders,2020,0,23,general,Middle
4051,1996,24,Lasker-DeBakey Clinical Medical Research Award,994,Contenders,2020,0,24,biology,Senior
4052,2004,15,Shanti Swarup Bhatnagar Prize for Science and Technology,446,Contenders,2019,0,15,general,Young
4053,2009,10,Shanti Swarup Bhatnagar Prize for Science and Technology,10,Contenders,2019,0,10,general,NA
4054,2005,11,MacArthur Fellowship,146,Contenders,2016,1,11,general,Young
4055,2009,10,Willard Gibbs Award,981,Contenders,2019,0,10,chemistry,Senior
4056,1981,30,Shanti Swarup Bhatnagar Prize for Science and Technology,708,Contenders,2011,1,30,general,Young
4057,2006,14,Shanti Swarup Bhatnagar Prize for Science and Technology,470,Contenders,2020,0,14,general,Young
4058,1955,56,Nobel Prize in Physiology or Medicine,196,Contenders,2011,1,56,biology,Middle
4059,2009,8,Nobel Prize in Physics,1197,Contenders,2017,1,8,physics,Senior
4060,1994,26,Fellow of the Royal Society,249,Contenders,2020,0,26,general,Young
4061,1983,37,Fellow of the Royal Society,902,Contenders,2020,0,37,general,Young
4062,1994,26,Fields Medal,138,Contenders,2020,0,26,mathematics,Young
4063,2009,6,Fellow of the Royal Society,375,Contenders,2015,1,6,general,Senior
4064,2014,1,Fellow of the Royal Society,1213,Contenders,2015,1,1,general,Senior
4065,2004,16,MacArthur Fellowship,564,Contenders,2020,0,16,general,Young
4066,2001,18,MacArthur Fellowship,690,Contenders,2019,0,18,general,Middle
4067,2002,18,Fellow of the Royal Society,1427,Contenders,2020,0,18,general,Middle
4068,2011,8,Max Planck Medal,1019,Contenders,2019,0,8,physics,Senior
4069,1992,27,MacArthur Fellowship,416,Contenders,2019,0,27,general,Young
4070,1986,33,MacArthur Fellowship,1264,Contenders,2019,0,33,general,Young
4071,1999,20,Fellow of the Royal Society,300,Contenders,2019,0,20,general,Middle
4072,1941,13,Fellow of the Royal Society,1218,Contenders,1954,1,13,general,Young
4073,1989,10,National Medal of Science,132,Contenders,1999,1,10,general,Senior
4074,2004,6,Shanti Swarup Bhatnagar Prize for Science and Technology,584,Contenders,2010,1,6,general,Young
4075,1981,0,Fellow of the Royal Society,472,Contenders,1981,1,0,general,Middle
4076,1989,31,Fellow of the Royal Society,1171,Contenders,2020,0,31,general,Middle
4077,1994,18,Lasker-DeBakey Clinical Medical Research Award,1329,Contenders,2012,1,18,biology,Senior
4078,2016,3,Fellow of the Royal Society,772,Contenders,2019,0,3,general,Young
4079,1976,23,Marconi Prize,1031,Contenders,1999,1,23,cs,Middle
4080,1975,44,Fellow of the Royal Society,226,Contenders,2019,0,44,general,Middle
4081,1978,41,Nobel Prize in Physiology or Medicine,5,Contenders,2019,0,41,biology,Middle
4082,2016,4,Fellow of the Royal Society,773,Contenders,2020,0,4,general,Middle
4083,1910,36,Fellow of the Royal Society,635,Contenders,1946,1,36,general,Young
4084,1998,18,Nobel Prize in Physics,369,Contenders,2016,1,18,physics,Middle
4085,1996,23,Turing Award,1054,Contenders,2019,0,23,cs,Middle
4086,2017,3,Breakthrough Prize in Life Sciences,374,Contenders,2020,0,3,biology,Senior
4087,2013,7,MacArthur Fellowship,64,Contenders,2020,0,7,general,Middle
4088,1988,21,Fellow of the Royal Society,1395,Contenders,2009,1,21,general,Young
4089,1999,11,Nobel Prize in Physiology or Medicine,277,Contenders,2010,1,11,biology,Senior
4090,1967,17,Nobel Prize in Physiology or Medicine,1300,Contenders,1984,1,17,biology,Senior
4091,1997,8,Nobel Prize in Chemistry,1255,Contenders,2005,1,8,chemistry,Senior
4092,2001,10,Wolf Prize in Chemistry,1222,Contenders,2011,1,10,chemistry,Senior
4093,1988,22,Nobel Prize in Chemistry,823,Contenders,2010,1,22,chemistry,Young
4094,2002,7,National Medal of Science,1223,Contenders,2009,1,7,general,Senior
4095,1985,10,Fellow of the Royal Society,1406,Contenders,1995,1,10,general,Young
4096,2015,3,Vautrin Lud Prize,295,Contenders,2018,0,3,geography,Senior
4097,2006,14,Fields Medal,948,Contenders,2020,0,14,mathematics,Young
4098,1966,0,Fellow of the Royal Society,1066,Contenders,1966,1,0,general,Young
4099,2012,8,Shanti Swarup Bhatnagar Prize for Science and Technology,468,Contenders,2020,0,8,general,Young
4100,2013,1,MacArthur Fellowship,1277,Contenders,2014,1,1,general,Young
4101,2004,16,Max Planck Medal,513,Contenders,2020,0,16,physics,Senior
4102,2014,5,Fellow of the Royal Society,695,Contenders,2019,0,5,general,Middle
4103,2014,6,Fellow of the Royal Society,695,Contenders,2020,0,6,general,Middle
4106,2008,11,MacArthur Fellowship,432,Contenders,2019,0,11,general,Young
4107,2000,19,Shanti Swarup Bhatnagar Prize for Science and Technology,767,Contenders,2019,0,19,general,Young
4108,2007,13,Shanti Swarup Bhatnagar Prize for Science and Technology,276,Contenders,2020,0,13,general,Young
4109,1986,31,Shanti Swarup Bhatnagar Prize for Science and Technology,115,Contenders,2017,1,31,general,Young
4110,1959,24,Nobel Prize in Physiology or Medicine,614,Contenders,1983,1,24,biology,Middle
4111,1972,11,Willard Gibbs Award,1238,Contenders,1983,1,11,chemistry,Senior
4112,1979,5,Shanti Swarup Bhatnagar Prize for Science and Technology,1306,Contenders,1984,1,5,general,Young
4113,1986,29,MacArthur Fellowship,973,Contenders,2015,1,29,general,Middle
4114,1995,25,Fellow of the Royal Society,1308,Contenders,2020,0,25,general,Middle
4115,1982,34,Shanti Swarup Bhatnagar Prize for Science and Technology,650,Contenders,2016,1,34,general,Young
4116,1986,34,Fields Medal,1268,Contenders,2020,0,34,mathematics,Young
4117,2016,4,Fellow of the Royal Society,528,Contenders,2020,0,4,general,NA
4118,1991,29,MacArthur Fellowship,533,Contenders,2020,0,29,general,Middle
4119,2015,5,Fellow of the Royal Society,1293,Contenders,2020,0,5,general,Senior
4120,1990,27,Fellow of the Royal Society,1056,Contenders,2017,1,27,general,Young
4121,2011,8,Shanti Swarup Bhatnagar Prize for Science and Technology,309,Contenders,2019,0,8,general,Young
4122,1997,15,Edison Medal,1388,Contenders,2012,1,15,cs,Senior
4123,1954,4,Nobel Prize in Physiology or Medicine,1430,Contenders,1958,1,4,biology,Young
4124,1978,27,Nobel Prize in Physics,1361,Contenders,2005,1,27,physics,Young
4125,2008,11,Wolf Prize in Medicine,16,Contenders,2019,0,11,biology,Senior
4126,2006,13,Shanti Swarup Bhatnagar Prize for Science and Technology,1259,Contenders,2019,0,13,general,NA
4127,2017,3,Fellow of the Royal Society,439,Contenders,2020,0,3,general,Senior
4128,2008,12,Fellow of the Royal Society,163,Contenders,2020,0,12,general,NA
4129,1981,33,Fellow of the Royal Society,1067,Contenders,2014,1,33,general,Young
4130,2009,10,Nobel Prize in Chemistry,44,Contenders,2019,0,10,chemistry,Senior
4131,2006,10,Wolf Prize in Physics,1335,Contenders,2016,1,10,physics,Senior
4132,2010,10,Fellow of the Royal Society,493,Contenders,2020,0,10,general,Middle
4135,1996,18,Shanti Swarup Bhatnagar Prize for Science and Technology,421,Contenders,2014,1,18,general,Young
4136,2015,3,Wolf Prize in Medicine,186,Contenders,2018,0,3,biology,Senior
4137,1984,36,MacArthur Fellowship,17,Contenders,2020,0,36,general,Middle
4138,2001,19,Willard Gibbs Award,935,Contenders,2020,0,19,chemistry,Middle
4139,1997,20,Nobel Prize in Chemistry,1255,Contenders,2017,1,20,chemistry,Senior
4140,1986,25,National Medal of Science,1254,Contenders,2011,1,25,general,Senior
4141,2006,14,MacArthur Fellowship,739,Contenders,2020,0,14,general,Young
4142,2013,6,Fellow of the Royal Society,737,Contenders,2019,0,6,general,Young
4143,1998,22,Shanti Swarup Bhatnagar Prize for Science and Technology,889,Contenders,2020,0,22,general,Young
4144,1983,3,Fellow of the Royal Society,902,Contenders,1986,1,3,general,Young
4145,1988,31,National Medal of Science,552,Contenders,2019,0,31,general,Senior
4146,1985,15,Edison Medal,770,Contenders,2000,1,15,cs,Senior
4147,2016,3,Wolf Prize in Physics,23,Contenders,2019,0,3,physics,Senior
4148,1994,25,Fellow of the Royal Society,1161,Contenders,2019,0,25,general,Young
4149,2012,5,MacArthur Fellowship,365,Contenders,2017,1,5,general,Young
4150,1978,29,Fellow of the Royal Society,629,Contenders,2007,1,29,general,Young
4151,2016,4,Lasker-DeBakey Clinical Medical Research Award,1125,Contenders,2020,0,4,biology,Senior
4152,2009,9,Shanti Swarup Bhatnagar Prize for Science and Technology,1188,Contenders,2018,0,9,general,Young
4153,1983,26,Fellow of the Royal Society,902,Contenders,2009,1,26,general,Young
4155,1995,15,MacArthur Fellowship,25,Contenders,2010,1,15,general,Middle
4156,2003,8,Shanti Swarup Bhatnagar Prize for Science and Technology,1162,Contenders,2011,1,8,general,Young
4157,1973,46,Fellow of the Royal Society,860,Contenders,2019,0,46,general,Young
4158,2007,4,SASTRA Ramanujan Prize,1123,Contenders,2011,1,4,mathematics,Young
4159,1982,37,MacArthur Fellowship,857,Contenders,2019,0,37,general,Middle
4160,2011,9,Nobel Prize in Physics,454,Contenders,2020,0,9,physics,Middle
4161,1989,30,Fellow of the Royal Society,1061,Contenders,2019,0,30,general,Middle
4162,2002,17,Fellow of the Royal Society,518,Contenders,2019,0,17,general,Middle
4163,1984,31,Fellow of the Royal Society,1232,Contenders,2015,1,31,general,Middle
4164,1987,11,Fellow of the Royal Society,92,Contenders,1998,1,11,general,Young
4165,2018,2,Wolf Prize in Chemistry,764,Contenders,2020,0,2,chemistry,Senior
4166,1947,70,Fellow of the Royal Society,1398,Contenders,2017,1,70,general,Middle
4167,1953,64,Nobel Prize in Physiology or Medicine,198,Contenders,2017,1,64,biology,Middle
4168,1967,50,Nobel Prize in Physiology or Medicine,1300,Contenders,2017,1,50,biology,Senior
4169,2017,3,Fellow of the Royal Society,1101,Contenders,2020,0,3,general,Senior
4170,1978,15,Fellow of the Royal Society,1184,Contenders,1993,1,15,general,Middle
4171,2014,6,Fields Medal,585,Contenders,2020,0,6,mathematics,Young
4172,2007,13,Shanti Swarup Bhatnagar Prize for Science and Technology,471,Contenders,2020,0,13,general,Young
4173,1977,24,Fellow of the Royal Society,478,Contenders,2001,1,24,general,Young
4175,2006,12,MacArthur Fellowship,739,Contenders,2018,0,12,general,Young
4176,2005,1,Wolf Prize in Physics,218,Contenders,2006,1,1,physics,Senior
4177,2008,12,MacArthur Fellowship,462,Contenders,2020,0,12,general,Young
4178,1980,13,Fellow of the Royal Society,1266,Contenders,1993,1,13,general,Middle
4179,2007,8,Fellow of the Royal Society,387,Contenders,2015,1,8,general,Middle
4180,1991,16,MacArthur Fellowship,626,Contenders,2007,1,16,general,Senior
4181,1990,30,MacArthur Fellowship,1199,Contenders,2020,0,30,general,Young
4182,2005,15,Fellow of the Royal Society,452,Contenders,2020,0,15,general,Senior
4183,2013,6,National Medal of Science,541,Contenders,2019,0,6,general,Middle
4184,2016,4,Shanti Swarup Bhatnagar Prize for Science and Technology,736,Contenders,2020,0,4,general,Young
4185,2010,10,National Medal of Science,281,Contenders,2020,0,10,general,Senior
4186,1988,32,Nobel Prize in Physics,1445,Contenders,2020,0,32,physics,Middle
4187,2007,5,Lasker-DeBakey Clinical Medical Research Award,800,Contenders,2012,1,5,biology,Senior
4188,1984,1,MacArthur Fellowship,998,Contenders,1985,1,1,general,Young
4189,2003,17,MacArthur Fellowship,753,Contenders,2020,0,17,general,Young
4190,2018,1,Breakthrough Prize in Life Sciences,72,Contenders,2019,0,1,biology,Senior
4191,2017,2,Fellow of the Royal Society,358,Contenders,2019,0,2,general,Senior
4192,2010,9,MacArthur Fellowship,122,Contenders,2019,0,9,general,Young
4193,2015,5,Nobel Prize in Physics,1356,Contenders,2020,0,5,physics,Middle
4194,2002,18,Shanti Swarup Bhatnagar Prize for Science and Technology,831,Contenders,2020,0,18,general,Young
4195,1937,13,Nobel Prize in Physiology or Medicine,1190,Contenders,1950,1,13,biology,Young
4197,1996,9,Willard Gibbs Award,467,Contenders,2005,1,9,chemistry,Senior
4198,2009,11,MacArthur Fellowship,75,Contenders,2020,0,11,general,Middle
4199,1992,27,Fellow of the Royal Society,318,Contenders,2019,0,27,general,Young
4200,1974,14,Fellow of the Royal Society,316,Contenders,1988,1,14,general,Young
4201,1988,16,Wolf Prize in Chemistry,836,Contenders,2004,1,16,chemistry,Middle
4203,1985,35,MacArthur Fellowship,1191,Contenders,2020,0,35,general,Middle
4204,2014,5,Fellow of the Royal Society,1213,Contenders,2019,0,5,general,Senior
4205,1977,25,Fellow of the Royal Society,984,Contenders,2002,1,25,general,Middle
4206,2002,18,Shanti Swarup Bhatnagar Prize for Science and Technology,843,Contenders,2020,0,18,general,Young
4207,1992,25,MacArthur Fellowship,929,Contenders,2017,1,25,general,Young
4208,2014,5,Fields Medal,983,Contenders,2019,0,5,mathematics,Young
4209,1965,44,Nobel Prize in Physiology or Medicine,303,Contenders,2009,1,44,biology,Middle
4210,2018,2,Fellow of the Royal Society,1095,Contenders,2020,0,2,general,NA
4211,2017,2,Wollaston Medal,907,Contenders,2019,0,2,geography,Middle
4212,2005,15,Wolf Prize in Medicine,126,Contenders,2020,0,15,biology,Senior
4213,1979,15,Wolf Prize in Medicine,1340,Contenders,1994,1,15,biology,Middle
4215,1974,17,Fellow of the Royal Society,1272,Contenders,1991,1,17,general,Middle
4216,1980,39,Fellow of the Royal Society,1295,Contenders,2019,0,39,general,Middle
4217,1992,14,Fellow of the Royal Society,557,Contenders,2006,1,14,general,Middle
4218,1995,11,Turing Award,1017,Contenders,2006,1,11,cs,Middle
4219,1964,5,Fellow of the Royal Society,684,Contenders,1969,1,5,general,Middle
4220,1997,8,MacArthur Fellowship,1156,Contenders,2005,1,8,general,Young
4221,1991,28,MacArthur Fellowship,533,Contenders,2019,0,28,general,Middle
4222,1964,16,Nobel Prize in Physiology or Medicine,1424,Contenders,1980,1,16,biology,Middle
4223,1988,28,Wolf Prize in Mathematics,936,Contenders,2016,1,28,mathematics,Senior
4224,2001,18,Fellow of the Royal Society,658,Contenders,2019,0,18,general,Middle
4225,2014,6,Fellow of the Royal Society,989,Contenders,2020,0,6,general,Senior
4227,1993,24,National Medal of Science,487,Contenders,2017,1,24,general,Senior
4228,2000,10,National Medal of Science,641,Contenders,2010,1,10,general,Senior
4229,2000,0,MacArthur Fellowship,381,Contenders,2000,1,0,general,Young
4230,1990,18,Fellow of the Royal Society,535,Contenders,2008,1,18,general,Middle
4231,2009,5,MacArthur Fellowship,485,Contenders,2014,1,5,general,Middle
4233,1975,26,Shanti Swarup Bhatnagar Prize for Science and Technology,1085,Contenders,2001,1,26,general,Young
4234,2003,17,National Medal of Science,77,Contenders,2020,0,17,general,Senior
4235,1998,22,Fellow of the Royal Society,465,Contenders,2020,0,22,general,Middle
4236,1967,2,Fellow of the Royal Society,1379,Contenders,1969,1,2,general,Young
4237,2015,4,Fellow of the Royal Society,875,Contenders,2019,0,4,general,Middle
4238,1977,33,Fellow of the Royal Society,984,Contenders,2010,1,33,general,Middle
4239,1992,27,MacArthur Fellowship,416,Contenders,2019,0,27,general,Young
4240,2012,7,Wolf Prize in Mathematics,124,Contenders,2019,0,7,mathematics,Senior
4241,2007,12,Fellow of the Royal Society,649,Contenders,2019,0,12,general,Senior
4242,1946,16,Fellow of the Royal Society,782,Contenders,1962,1,16,general,Senior
4243,2004,16,Fellow of the Royal Society,1110,Contenders,2020,0,16,general,Senior
4244,1990,27,Shanti Swarup Bhatnagar Prize for Science and Technology,888,Contenders,2017,1,27,general,Young
4245,1952,23,Nobel Prize in Physics,1346,Contenders,1975,1,23,physics,Middle
4247,1999,3,Fellow of the Royal Society,300,Contenders,2002,1,3,general,Middle
4248,1962,57,Fields Medal,74,Contenders,2019,0,57,mathematics,Young
4249,1971,35,Shanti Swarup Bhatnagar Prize for Science and Technology,476,Contenders,2006,1,35,general,Young
4250,1944,6,Nobel Prize in Physics,1285,Contenders,1950,1,6,physics,Middle
4251,1985,32,MacArthur Fellowship,46,Contenders,2017,1,32,general,Young
4255,1998,22,Nobel Prize in Physics,369,Contenders,2020,0,22,physics,Middle
4256,2011,8,Fellow of the Royal Society,853,Contenders,2019,0,8,general,Senior
4257,2009,11,Fellow of the Royal Society,821,Contenders,2020,0,11,general,Middle
4258,1996,19,Nobel Prize in Physics,886,Contenders,2015,1,19,physics,Middle
4259,1934,75,Fellow of the Royal Society,892,Contenders,2009,1,75,general,Middle
4260,1988,11,National Medal of Science,200,Contenders,1999,1,11,general,Senior
4261,1993,27,MacArthur Fellowship,1443,Contenders,2020,0,27,general,Young
4262,2014,6,Breakthrough Prize in Life Sciences,1004,Contenders,2020,0,6,biology,Senior
4263,2012,8,Fellow of the Royal Society,957,Contenders,2020,0,8,general,Young
4264,2005,14,Fellow of the Royal Society,941,Contenders,2019,0,14,general,Middle
4265,1994,21,Fellow of the Royal Society,52,Contenders,2015,1,21,general,Middle
4266,1964,51,Nobel Prize in Physics,379,Contenders,2015,1,51,physics,Young
4267,2009,3,Fellow of the Royal Society,375,Contenders,2012,1,3,general,Senior
4268,1989,22,Fellow of the Royal Society,348,Contenders,2011,1,22,general,Young
4270,2006,14,Fellow of the Royal Society,247,Contenders,2020,0,14,general,NA
4271,2013,6,Fellow of the Royal Society,512,Contenders,2019,0,6,general,Senior
4272,1995,24,Shanti Swarup Bhatnagar Prize for Science and Technology,1270,Contenders,2019,0,24,general,Young
4273,2014,6,Shanti Swarup Bhatnagar Prize for Science and Technology,944,Contenders,2020,0,6,general,Young
4274,1999,19,Fellow of the Royal Society,1049,Contenders,2018,0,19,general,Middle
4275,2013,7,Fellow of the Royal Society,569,Contenders,2020,0,7,general,Middle
4277,1987,30,MacArthur Fellowship,526,Contenders,2017,1,30,general,Young
4278,2017,3,Fellow of the Royal Society,715,Contenders,2020,0,3,general,NA
4279,2006,13,Shanti Swarup Bhatnagar Prize for Science and Technology,895,Contenders,2019,0,13,general,NA
4280,2003,17,Shanti Swarup Bhatnagar Prize for Science and Technology,1010,Contenders,2020,0,17,general,Middle
4281,1963,36,Nobel Prize in Physics,1350,Contenders,1999,1,36,physics,Middle
4282,1978,42,Fellow of the Royal Society,882,Contenders,2020,0,42,general,Middle
4284,2009,11,Fellow of the Royal Society,457,Contenders,2020,0,11,general,Middle
4286,1986,24,MacArthur Fellowship,595,Contenders,2010,1,24,general,Young
4287,1978,29,Wolf Prize in Medicine,1391,Contenders,2007,1,29,biology,Middle
4289,1968,16,Nobel Prize in Physiology or Medicine,1200,Contenders,1984,1,16,biology,Middle
4290,1992,28,MacArthur Fellowship,929,Contenders,2020,0,28,general,Young
4291,1990,18,Shanti Swarup Bhatnagar Prize for Science and Technology,449,Contenders,2008,1,18,general,Young
4292,2008,11,Fellow of the Royal Society,149,Contenders,2019,0,11,general,NA
4293,2007,12,Bigsby Medal,211,Contenders,2019,0,12,geography,Young
4294,2006,13,Shanti Swarup Bhatnagar Prize for Science and Technology,1259,Contenders,2019,0,13,general,NA
4295,2001,16,Fellow of the Royal Society,986,Contenders,2017,1,16,general,Middle
4297,1991,17,National Medal of Science,752,Contenders,2008,1,17,general,Senior
4298,2014,6,Lasker-DeBakey Clinical Medical Research Award,1175,Contenders,2020,0,6,biology,Senior
4299,2017,2,Fellow of the Royal Society,556,Contenders,2019,0,2,general,Senior
4300,1993,27,Shanti Swarup Bhatnagar Prize for Science and Technology,610,Contenders,2020,0,27,general,Young
4301,1979,25,Turing Award,1315,Contenders,2004,1,25,cs,Middle
4302,2016,3,Vautrin Lud Prize,1053,Contenders,2019,0,3,geography,Senior
4304,1979,31,Shanti Swarup Bhatnagar Prize for Science and Technology,1306,Contenders,2010,1,31,general,Young
4306,2015,4,Fellow of the Royal Society,875,Contenders,2019,0,4,general,Middle
4307,2000,18,Turing Award,572,Contenders,2018,0,18,cs,Middle
4308,2001,17,Fellow of the Royal Society,568,Contenders,2018,0,17,general,Middle
4309,1954,50,Lasker-DeBakey Clinical Medical Research Award,222,Contenders,2004,1,50,biology,Middle
4310,2008,12,Hughes Medal,1415,Contenders,2020,0,12,physics,Middle
4311,1994,13,Lasker-DeBakey Clinical Medical Research Award,1329,Contenders,2007,1,13,biology,Senior
4312,2006,12,Nobel Prize in Chemistry,60,Contenders,2018,0,12,chemistry,Middle
4315,2015,4,Shanti Swarup Bhatnagar Prize for Science and Technology,1116,Contenders,2019,0,4,general,Young
4317,2012,7,Max Planck Medal,1150,Contenders,2019,0,7,physics,Middle
4318,1997,22,Fellow of the Royal Society,451,Contenders,2019,0,22,general,Middle
4319,2008,12,Wolf Prize in Chemistry,107,Contenders,2020,0,12,chemistry,Middle
4320,2006,13,Fellow of the Royal Society,1005,Contenders,2019,0,13,general,Middle
4321,1994,5,Shanti Swarup Bhatnagar Prize for Science and Technology,269,Contenders,1999,1,5,general,Young
4322,1991,3,Shanti Swarup Bhatnagar Prize for Science and Technology,150,Contenders,1994,1,3,general,Young
4323,2016,4,Wolf Prize in Physics,23,Contenders,2020,0,4,physics,Senior
4324,1981,29,Fellow of the Royal Society,1401,Contenders,2010,1,29,general,Young
4325,1995,24,MacArthur Fellowship,788,Contenders,2019,0,24,general,Young
4326,2017,3,Nobel Prize in Physics,188,Contenders,2020,0,3,physics,Senior
4327,1987,14,Fellow of the Royal Society,763,Contenders,2001,1,14,general,Senior
4328,1987,33,MacArthur Fellowship,313,Contenders,2020,0,33,general,Young
4329,2006,14,Fellow of the Royal Society,873,Contenders,2020,0,14,general,Middle
4330,2017,3,Wolf Prize in Physics,632,Contenders,2020,0,3,physics,Senior
4331,1983,13,Fellow of the Royal Society,542,Contenders,1996,1,13,general,Middle
4332,2007,9,Willard Gibbs Award,435,Contenders,2016,1,9,chemistry,Middle
4333,1987,11,Fellow of the Royal Society,859,Contenders,1998,1,11,general,Middle
4334,1970,45,Fellow of the Royal Society,995,Contenders,2015,1,45,general,Senior
4335,1984,25,MacArthur Fellowship,230,Contenders,2009,1,25,general,Middle
4336,1998,22,Fellow of the Royal Society,1287,Contenders,2020,0,22,general,NA
4337,2014,2,Lasker-DeBakey Clinical Medical Research Award,1260,Contenders,2016,1,2,biology,NA
4338,1991,21,Fellow of the Royal Society,1307,Contenders,2012,1,21,general,Middle
4339,2015,5,Fellow of the Royal Society,337,Contenders,2020,0,5,general,Middle
4340,1991,26,Fellow of the Royal Society,178,Contenders,2017,1,26,general,Middle
4341,1991,19,National Medal of Science,1057,Contenders,2010,1,19,general,Middle
4342,1981,38,MacArthur Fellowship,1364,Contenders,2019,0,38,general,Young
4344,1980,37,Wolf Prize in Physics,765,Contenders,2017,1,37,physics,Young
4345,2000,20,Nobel Prize in Physics,799,Contenders,2020,0,20,physics,Senior
4346,1998,21,National Medal of Science,1104,Contenders,2019,0,21,general,Senior
4347,2008,9,Max Planck Medal,1366,Contenders,2017,1,9,physics,Senior
4348,1957,14,Nobel Prize in Physiology or Medicine,1327,Contenders,1971,1,14,biology,Middle
4349,2016,4,Shanti Swarup Bhatnagar Prize for Science and Technology,808,Contenders,2020,0,4,general,Young
4350,2014,6,Fellow of the Royal Society,410,Contenders,2020,0,6,general,Middle
4351,2014,3,Willard Gibbs Award,195,Contenders,2017,1,3,chemistry,Senior
4352,1978,39,Nobel Prize in Physics,1361,Contenders,2017,1,39,physics,Young
4353,1998,22,National Medal of Science,1104,Contenders,2020,0,22,general,Senior
4354,2006,13,Fellow of the Royal Society,1060,Contenders,2019,0,13,general,Senior
4355,2008,12,Shanti Swarup Bhatnagar Prize for Science and Technology,181,Contenders,2020,0,12,general,Young
4356,1993,26,Fellow of the Royal Society,441,Contenders,2019,0,26,general,Young
4357,1979,30,National Medal of Science,1059,Contenders,2009,1,30,general,Middle
4358,2003,11,Fellow of the Royal Society,297,Contenders,2014,1,11,general,Senior
4359,1988,23,Nobel Prize in Chemistry,969,Contenders,2011,1,23,chemistry,Middle
4360,1998,11,Fellow of the Royal Society,915,Contenders,2009,1,11,general,Middle
4361,1983,25,National Medal of Science,1403,Contenders,2008,1,25,general,Senior
4362,1986,33,Max Planck Medal,250,Contenders,2019,0,33,physics,Middle
4363,2001,18,Nobel Prize in Physiology or Medicine,742,Contenders,2019,0,18,biology,Middle
4364,1981,35,MacArthur Fellowship,959,Contenders,2016,1,35,general,Young
4365,2004,16,Fellow of the Royal Society,914,Contenders,2020,0,16,general,Middle
4366,1980,36,Marconi Prize,412,Contenders,2016,1,36,cs,Middle
4367,2015,4,Fellow of the Royal Society,322,Contenders,2019,0,4,general,NA
4368,2018,1,Fellow of the Royal Society,1387,Contenders,2019,0,1,general,Middle
4369,1983,35,Shanti Swarup Bhatnagar Prize for Science and Technology,1428,Contenders,2018,0,35,general,Young
4370,2004,16,Fellow of the Royal Society,777,Contenders,2020,0,16,general,Middle
4372,1992,28,MacArthur Fellowship,35,Contenders,2020,0,28,general,Middle
4373,1991,21,National Medal of Science,1057,Contenders,2012,1,21,general,Middle
4374,1979,10,Shanti Swarup Bhatnagar Prize for Science and Technology,1306,Contenders,1989,1,10,general,Young
4375,2004,16,Wolf Prize in Medicine,288,Contenders,2020,0,16,biology,Middle
4376,1967,43,Bigsby Medal,751,Contenders,2010,1,43,geography,Young
4377,1985,35,MacArthur Fellowship,1118,Contenders,2020,0,35,general,Middle
4378,1990,30,Fellow of the Royal Society,158,Contenders,2020,0,30,general,Middle
4379,1998,21,Fellow of the Royal Society,492,Contenders,2019,0,21,general,Middle
4380,1975,19,National Medal of Science,904,Contenders,1994,1,19,general,Senior
4381,2014,6,Lasker-DeBakey Clinical Medical Research Award,1175,Contenders,2020,0,6,biology,Senior
4382,2001,14,Wolf Prize in Medicine,251,Contenders,2015,1,14,biology,Senior
4383,1976,38,Nobel Prize in Physics,924,Contenders,2014,1,38,physics,Young
4384,2001,7,Cullum Geographical Medal,652,Contenders,2008,1,7,geography,Senior
4385,2017,2,Fellow of the Royal Society,1173,Contenders,2019,0,2,general,Senior
4387,1987,33,MacArthur Fellowship,1367,Contenders,2020,0,33,general,Young
4388,2008,12,Fellow of the Royal Society,794,Contenders,2020,0,12,general,Middle
4389,1981,16,MacArthur Fellowship,45,Contenders,1997,1,16,general,Young
4390,1993,25,MacArthur Fellowship,1443,Contenders,2018,0,25,general,Young
4391,1967,25,Shanti Swarup Bhatnagar Prize for Science and Technology,1082,Contenders,1992,1,25,general,Young
4392,1993,27,Shanti Swarup Bhatnagar Prize for Science and Technology,610,Contenders,2020,0,27,general,Young
4393,2001,19,Fellow of the Royal Society,643,Contenders,2020,0,19,general,NA
4394,2001,9,Wolf Prize in Medicine,251,Contenders,2010,1,9,biology,Senior
4395,1972,0,Fellow of the Royal Society,733,Contenders,1972,1,0,general,Young
4396,1967,46,Bigsby Medal,751,Contenders,2013,1,46,geography,Young
4397,1956,31,Fellow of the Royal Society,1342,Contenders,1987,1,31,general,Young
4399,1938,25,Fellow of the Royal Society,744,Contenders,1963,1,25,general,Young
4400,1979,19,Fellow of the Royal Society,991,Contenders,1998,1,19,general,Middle
4401,1997,12,Nobel Prize in Chemistry,1255,Contenders,2009,1,12,chemistry,Senior
4402,1980,13,Fellow of the Royal Society,1265,Contenders,1993,1,13,general,NA
4403,1985,34,Shanti Swarup Bhatnagar Prize for Science and Technology,961,Contenders,2019,0,34,general,Young
4404,2001,19,Nobel Prize in Physics,69,Contenders,2020,0,19,physics,Young
4405,1983,37,National Medal of Science,943,Contenders,2020,0,37,general,Young
4406,1986,33,Shanti Swarup Bhatnagar Prize for Science and Technology,1100,Contenders,2019,0,33,general,Young
4407,2007,12,Fellow of the Royal Society,380,Contenders,2019,0,12,general,Middle
4409,2013,7,Nobel Prize in Physiology or Medicine,1103,Contenders,2020,0,7,biology,Senior
4410,2005,14,Fellow of the Royal Society,941,Contenders,2019,0,14,general,Middle
4411,1994,26,National Medal of Science,1397,Contenders,2020,0,26,general,Senior
4412,1997,13,Fellow of the Royal Society,975,Contenders,2010,1,13,general,Young
4413,1986,28,Fellow of the Royal Society,1448,Contenders,2014,1,28,general,Middle
4414,2007,9,Fellow of the Royal Society,114,Contenders,2016,1,9,general,Middle
4415,2016,3,Shanti Swarup Bhatnagar Prize for Science and Technology,389,Contenders,2019,0,3,general,Young
4416,1989,27,Fellow of the Royal Society,531,Contenders,2016,1,27,general,Young
4417,1997,13,MacArthur Fellowship,600,Contenders,2010,1,13,general,Young
4418,2009,10,MacArthur Fellowship,75,Contenders,2019,0,10,general,Middle
4419,2001,15,Fellow of the Royal Society,1288,Contenders,2016,1,15,general,Middle
4420,2004,14,Fellow of the Royal Society,1117,Contenders,2018,0,14,general,Senior
4421,1999,17,Fellow of the Royal Society,511,Contenders,2016,1,17,general,Middle
4422,1971,21,Fellow of the Royal Society,314,Contenders,1992,1,21,general,Young
4423,1983,9,National Medal of Science,1371,Contenders,1992,1,9,general,Senior
4424,2017,2,Fellow of the Royal Society,1239,Contenders,2019,0,2,general,Middle
4425,1998,14,Fellow of the Royal Society,612,Contenders,2012,1,14,general,Young
4426,1998,19,Fields Medal,466,Contenders,2017,1,19,mathematics,Young
4427,1975,17,Shanti Swarup Bhatnagar Prize for Science and Technology,1348,Contenders,1992,1,17,general,Young
4428,2014,6,Breakthrough Prize in Life Sciences,85,Contenders,2020,0,6,biology,Senior
4429,1968,32,Nobel Prize in Physiology or Medicine,290,Contenders,2000,1,32,biology,Middle
4430,2000,20,MacArthur Fellowship,741,Contenders,2020,0,20,general,Young
4431,1995,7,MacArthur Fellowship,788,Contenders,2002,1,7,general,Young
4432,2006,14,Fellow of the Royal Society,11,Contenders,2020,0,14,general,Middle
4433,2001,16,Nobel Prize in Chemistry,21,Contenders,2017,1,16,chemistry,Senior
4434,2005,12,Nobel Prize in Chemistry,140,Contenders,2017,1,12,chemistry,Middle
4435,1953,33,Fellow of the Royal Society,355,Contenders,1986,1,33,general,Young
4436,1972,37,Nobel Prize in Physiology or Medicine,205,Contenders,2009,1,37,biology,Young
4437,1990,22,Fellow of the Royal Society,535,Contenders,2012,1,22,general,Middle
4438,1992,20,National Medal of Science,384,Contenders,2012,1,20,general,Senior
4439,1964,4,Fellow of the Royal Society,1389,Contenders,1968,1,4,general,Young
4440,1997,23,Fellow of the Royal Society,118,Contenders,2020,0,23,general,Middle
4441,2017,1,Nobel Prize in Physics,308,Contenders,2018,0,1,physics,Senior
4442,1981,1,Fellow of the Royal Society,1345,Contenders,1982,1,1,general,Middle
4443,1978,31,Shanti Swarup Bhatnagar Prize for Science and Technology,521,Contenders,2009,1,31,general,Young
4444,2001,11,National Medal of Science,339,Contenders,2012,1,11,general,Senior
4445,1985,32,Shanti Swarup Bhatnagar Prize for Science and Technology,679,Contenders,2017,1,32,general,Young
4446,2002,18,MacArthur Fellowship,315,Contenders,2020,0,18,general,Young
4447,2013,6,Fellow of the Royal Society,1326,Contenders,2019,0,6,general,Middle
4448,1982,36,Fellow of the Royal Society,1149,Contenders,2018,0,36,general,Young
4449,2009,11,Fellow of the Royal Society,834,Contenders,2020,0,11,general,Middle
4450,2007,3,National Medal of Science,861,Contenders,2010,1,3,general,Senior
4451,1984,34,MacArthur Fellowship,1383,Contenders,2018,0,34,general,Young
4452,1957,29,Fellow of the Royal Society,1063,Contenders,1986,1,29,general,Middle
4453,2015,5,Fellow of the Royal Society,363,Contenders,2020,0,5,general,NA
4454,1975,31,Nobel Prize in Physiology or Medicine,746,Contenders,2006,1,31,biology,Young
4455,1968,44,Fellow of the Royal Society,1339,Contenders,2012,1,44,general,Young
4456,1975,37,Fellow of the Royal Society,226,Contenders,2012,1,37,general,Middle
4457,1970,34,National Medal of Science,338,Contenders,2004,1,34,general,Middle
4459,2002,17,National Medal of Science,1208,Contenders,2019,0,17,general,Senior
4461,2008,12,National Medal of Science,916,Contenders,2020,0,12,general,Senior
4462,1971,3,Fellow of the Royal Society,1230,Contenders,1974,1,3,general,Young
4463,1963,27,National Medal of Science,898,Contenders,1990,1,27,general,Senior
4464,1980,18,Fellow of the Royal Society,1375,Contenders,1998,1,18,general,Young
4465,2006,8,MacArthur Fellowship,458,Contenders,2014,1,8,general,Middle
4466,1995,3,Fellow of the Royal Society,121,Contenders,1998,1,3,general,Middle
4467,1992,21,Nobel Prize in Physiology or Medicine,677,Contenders,2013,1,21,biology,Senior
4468,1989,7,Fellow of the Royal Society,399,Contenders,1996,1,7,general,Young
4469,1974,34,Shanti Swarup Bhatnagar Prize for Science and Technology,1299,Contenders,2008,1,34,general,Young
4470,1974,23,Fields Medal,362,Contenders,1997,1,23,mathematics,Young
4471,2016,4,Shanti Swarup Bhatnagar Prize for Science and Technology,603,Contenders,2020,0,4,general,NA
4472,1996,17,Shanti Swarup Bhatnagar Prize for Science and Technology,239,Contenders,2013,1,17,general,Young
4474,2007,13,MacArthur Fellowship,841,Contenders,2020,0,13,general,Young
4475,1996,18,Willard Gibbs Award,467,Contenders,2014,1,18,chemistry,Senior
4476,1983,18,National Medal of Science,1403,Contenders,2001,1,18,general,Senior
4478,1971,17,Shanti Swarup Bhatnagar Prize for Science and Technology,476,Contenders,1988,1,17,general,Young
4479,1947,29,Fellow of the Royal Society,1398,Contenders,1976,1,29,general,Middle
4480,1967,25,Fellow of the Royal Society,856,Contenders,1992,1,25,general,Young
4481,1997,19,MacArthur Fellowship,1156,Contenders,2016,1,19,general,Young
4482,1984,34,Fellow of the Royal Society,20,Contenders,2018,0,34,general,Young
4483,2009,8,Fellow of the Royal Society,375,Contenders,2017,1,8,general,Senior
4485,2016,3,Fellow of the Royal Society,930,Contenders,2019,0,3,general,Middle
4486,2015,5,Nobel Prize in Physiology or Medicine,234,Contenders,2020,0,5,biology,Senior
4487,1963,12,Bigsby Medal,1444,Contenders,1975,1,12,geography,Young
4488,1990,1,MacArthur Fellowship,156,Contenders,1991,1,1,general,Middle
4489,1990,29,Fellow of the Royal Society,960,Contenders,2019,0,29,general,Middle
4490,2007,13,Shanti Swarup Bhatnagar Prize for Science and Technology,1032,Contenders,2020,0,13,general,NA
4491,1994,8,Fellow of the Royal Society,293,Contenders,2002,1,8,general,Young
4492,1993,24,Fellow of the Royal Society,110,Contenders,2017,1,24,general,Young
4493,1923,5,Willard Gibbs Award,807,Contenders,1928,1,5,chemistry,Middle
4494,1972,0,Fellow of the Royal Society,733,Contenders,1972,1,0,general,Young
4495,2014,5,Vautrin Lud Prize,207,Contenders,2019,0,5,geography,Senior
4496,2000,10,Shanti Swarup Bhatnagar Prize for Science and Technology,767,Contenders,2010,1,10,general,Young
4497,1963,53,Lasker-DeBakey Clinical Medical Research Award,1321,Contenders,2016,1,53,biology,Senior
4498,1964,52,National Medal of Science,701,Contenders,2016,1,52,general,Middle
4499,1923,43,Fellow of the Royal Society,580,Contenders,1966,1,43,general,Young
4500,1983,36,Fellow of the Royal Society,1438,Contenders,2019,0,36,general,Middle
4502,1975,22,Shanti Swarup Bhatnagar Prize for Science and Technology,1085,Contenders,1997,1,22,general,Young
4503,1976,22,Fellow of the Royal Society,945,Contenders,1998,1,22,general,Young
4504,1993,5,Fellow of the Royal Society,1051,Contenders,1998,1,5,general,Young
4506,1997,18,National Medal of Science,750,Contenders,2015,1,18,general,Senior
4507,1993,27,MacArthur Fellowship,1014,Contenders,2020,0,27,general,Young
4508,2016,4,Fellow of the Royal Society,768,Contenders,2020,0,4,general,NA
4509,1963,18,Bigsby Medal,1444,Contenders,1981,1,18,geography,Young
4510,1965,47,National Medal of Science,1416,Contenders,2012,1,47,general,Young
4512,1991,19,Shanti Swarup Bhatnagar Prize for Science and Technology,150,Contenders,2010,1,19,general,Young
4513,1992,16,MacArthur Fellowship,165,Contenders,2008,1,16,general,Senior
4514,2010,4,National Medal of Science,762,Contenders,2014,1,4,general,Senior
4515,2001,17,Fellow of the Royal Society,256,Contenders,2018,0,17,general,Middle
4516,1997,14,Fellow of the Royal Society,3,Contenders,2011,1,14,general,Middle
4517,1983,21,MacArthur Fellowship,39,Contenders,2004,1,21,general,Young
4518,2005,15,Nobel Prize in Chemistry,140,Contenders,2020,0,15,chemistry,Middle
4519,1960,0,Nobel Prize in Physics,1419,Contenders,1960,1,0,physics,Young
4520,1962,24,Fellow of the Royal Society,1243,Contenders,1986,1,24,general,Middle
4521,1989,30,Fellow of the Royal Society,531,Contenders,2019,0,30,general,Young
4522,1986,31,MacArthur Fellowship,595,Contenders,2017,1,31,general,Young
4523,1957,53,Nobel Prize in Physiology or Medicine,1327,Contenders,2010,1,53,biology,Middle
4524,2004,9,Wolf Prize in Medicine,288,Contenders,2013,1,9,biology,Middle
4525,1995,1,Nobel Prize in Chemistry,625,Contenders,1996,1,1,chemistry,Middle
4527,2003,13,Fellow of the Royal Society,1137,Contenders,2016,1,13,general,Middle
4528,2017,2,Fellow of the Royal Society,1194,Contenders,2019,0,2,general,NA
4530,1984,35,Fellow of the Royal Society,583,Contenders,2019,0,35,general,Middle
4531,1985,34,Fellow of the Royal Society,849,Contenders,2019,0,34,general,Middle
4532,1972,34,Fellow of the Royal Society,976,Contenders,2006,1,34,general,Middle
4533,1999,19,Shanti Swarup Bhatnagar Prize for Science and Technology,1090,Contenders,2018,0,19,general,Young
4534,1979,40,Fellow of the Royal Society,1216,Contenders,2019,0,40,general,Young
4535,1989,11,Shanti Swarup Bhatnagar Prize for Science and Technology,1112,Contenders,2000,1,11,general,NA
4536,1968,4,Fellow of the Royal Society,967,Contenders,1972,1,4,general,Young
4537,1996,23,Lasker-DeBakey Clinical Medical Research Award,994,Contenders,2019,0,23,biology,Senior
4538,2001,17,Willard Gibbs Award,935,Contenders,2018,0,17,chemistry,Middle
4539,1966,14,Lasker-DeBakey Clinical Medical Research Award,982,Contenders,1980,1,14,biology,Senior
4540,2009,10,Fellow of the Royal Society,821,Contenders,2019,0,10,general,Middle
4542,1954,52,Fellow of the Royal Society,880,Contenders,2006,1,52,general,Young
4543,1998,21,MacArthur Fellowship,1157,Contenders,2019,0,21,general,Middle
4544,1990,28,Fellow of the Royal Society,760,Contenders,2018,0,28,general,Young
4546,1997,22,Shanti Swarup Bhatnagar Prize for Science and Technology,404,Contenders,2019,0,22,general,Young
4547,2006,13,MacArthur Fellowship,685,Contenders,2019,0,13,general,Young
4548,1990,30,Shanti Swarup Bhatnagar Prize for Science and Technology,67,Contenders,2020,0,30,general,Young
4550,2017,0,Fellow of the Royal Society,556,Contenders,2017,1,0,general,Senior
4551,1998,22,Nobel Prize in Physics,952,Contenders,2020,0,22,physics,Middle
4552,1974,6,Lasker-DeBakey Clinical Medical Research Award,1336,Contenders,1980,1,6,biology,Senior
4555,1979,28,Fellow of the Royal Society,393,Contenders,2007,1,28,general,Middle
4556,1998,22,Wolf Prize in Medicine,292,Contenders,2020,0,22,biology,Senior
4557,2011,8,Fellow of the Royal Society,65,Contenders,2019,0,8,general,Middle
4559,1983,33,MacArthur Fellowship,51,Contenders,2016,1,33,general,Middle
4560,1966,21,Shanti Swarup Bhatnagar Prize for Science and Technology,713,Contenders,1987,1,21,general,Young
4561,2000,20,MacArthur Fellowship,775,Contenders,2020,0,20,general,Young
4562,2014,6,Fellow of the Royal Society,695,Contenders,2020,0,6,general,Middle
4563,2005,9,Shanti Swarup Bhatnagar Prize for Science and Technology,326,Contenders,2014,1,9,general,Young
4564,2007,12,MacArthur Fellowship,841,Contenders,2019,0,12,general,Young
4565,2016,3,MacArthur Fellowship,570,Contenders,2019,0,3,general,Young
4566,2008,12,Fellow of the Royal Society,560,Contenders,2020,0,12,general,Middle
4567,2001,19,Fellow of the Royal Society,688,Contenders,2020,0,19,general,Middle
4568,1993,23,Max Planck Medal,400,Contenders,2016,1,23,physics,Middle
4569,2008,7,Nobel Prize in Physics,1207,Contenders,2015,1,7,physics,Senior
4570,2017,3,Nobel Prize in Physics,1252,Contenders,2020,0,3,physics,Senior
4571,1983,0,Fellow of the Royal Society,1025,Contenders,1983,1,0,general,Middle
4572,2017,3,Fellow of the Royal Society,439,Contenders,2020,0,3,general,Senior
4573,1962,42,Fellow of the Royal Society,1105,Contenders,2004,1,42,general,Young
4574,1993,24,Fellow of the Royal Society,826,Contenders,2017,1,24,general,NA
4575,1989,30,National Medal of Science,132,Contenders,2019,0,30,general,Senior
4576,1993,21,MacArthur Fellowship,84,Contenders,2014,1,21,general,Middle
4577,2012,5,National Medal of Science,1077,Contenders,2017,1,5,general,Senior
4578,1983,29,Fellow of the Royal Society,135,Contenders,2012,1,29,general,Young
4579,1986,23,Fellow of the Royal Society,1448,Contenders,2009,1,23,general,Middle
4580,2003,6,Max Planck Medal,515,Contenders,2009,1,6,physics,Senior
4584,2000,18,MacArthur Fellowship,351,Contenders,2018,0,18,general,NA
4585,1988,32,MacArthur Fellowship,865,Contenders,2020,0,32,general,Young
4586,2017,1,Nobel Prize in Physics,1252,Contenders,2018,0,1,physics,Senior
4589,2008,11,Fellow of the Royal Society,352,Contenders,2019,0,11,general,Young
4590,2010,10,MacArthur Fellowship,1313,Contenders,2020,0,10,general,Young
4591,1990,17,Fellow of the Royal Society,760,Contenders,2007,1,17,general,Young
4592,1992,21,MacArthur Fellowship,1092,Contenders,2013,1,21,general,Middle
4593,1994,24,MacArthur Fellowship,191,Contenders,2018,0,24,general,Young
4594,2011,8,Shanti Swarup Bhatnagar Prize for Science and Technology,1153,Contenders,2019,0,8,general,NA
4595,2008,12,Fellow of the Royal Society,794,Contenders,2020,0,12,general,Middle
4596,2007,9,Fellow of the Royal Society,550,Contenders,2016,1,9,general,NA
4597,1988,25,Shanti Swarup Bhatnagar Prize for Science and Technology,1347,Contenders,2013,1,25,general,Young
4598,2004,16,Nobel Prize in Physiology or Medicine,406,Contenders,2020,0,16,biology,Middle
4599,1983,7,MacArthur Fellowship,748,Contenders,1990,1,7,general,Young
4600,1981,20,Fellow of the Royal Society,349,Contenders,2001,1,20,general,Middle
4601,1995,8,Fellow of the Royal Society,1308,Contenders,2003,1,8,general,Middle
4602,1971,47,Fellow of the Royal Society,314,Contenders,2018,0,47,general,Young
4603,1986,34,MacArthur Fellowship,950,Contenders,2020,0,34,general,Young
4604,1992,28,MacArthur Fellowship,908,Contenders,2020,0,28,general,Middle
4605,2005,14,Shanti Swarup Bhatnagar Prize for Science and Technology,663,Contenders,2019,0,14,general,Young
4606,1973,7,Shanti Swarup Bhatnagar Prize for Science and Technology,1192,Contenders,1980,1,7,general,Young
4607,2018,2,Fellow of the Royal Society,286,Contenders,2020,0,2,general,Senior
4608,2009,8,Fellow of the Royal Society,429,Contenders,2017,1,8,general,Middle
4610,2009,1,Lasker-DeBakey Clinical Medical Research Award,1204,Contenders,2010,1,1,biology,Middle
4611,1987,30,Shanti Swarup Bhatnagar Prize for Science and Technology,721,Contenders,2017,1,30,general,Young
4612,2001,12,Cullum Geographical Medal,652,Contenders,2013,1,12,geography,Senior
4613,2008,11,Shanti Swarup Bhatnagar Prize for Science and Technology,105,Contenders,2019,0,11,general,Young
4614,1990,28,Nobel Prize in Physics,1412,Contenders,2018,0,28,physics,Middle
4615,1974,41,Fellow of the Royal Society,220,Contenders,2015,1,41,general,Young
4616,2001,8,Fellow of the Royal Society,837,Contenders,2009,1,8,general,Middle
4617,2000,17,Edison Medal,1124,Contenders,2017,1,17,cs,Senior
4618,1993,27,Willard Gibbs Award,189,Contenders,2020,0,27,chemistry,Middle
4619,1938,68,Fellow of the Royal Society,744,Contenders,2006,1,68,general,Young
4620,1947,59,Fellow of the Royal Society,495,Contenders,2006,1,59,general,Middle
4621,2009,10,Shanti Swarup Bhatnagar Prize for Science and Technology,1394,Contenders,2019,0,10,general,Young
4622,2002,17,Fellow of the Royal Society,1030,Contenders,2019,0,17,general,Middle
4623,1998,19,Nobel Prize in Physiology or Medicine,1198,Contenders,2017,1,19,biology,Middle
4625,1983,30,Shanti Swarup Bhatnagar Prize for Science and Technology,716,Contenders,2013,1,30,general,Young
4626,1954,20,Fellow of the Royal Society,14,Contenders,1974,1,20,general,Middle
4627,2009,7,Shanti Swarup Bhatnagar Prize for Science and Technology,1188,Contenders,2016,1,7,general,Young
4628,1982,25,Wollaston Medal,258,Contenders,2007,1,25,geography,Middle
4629,1982,20,Wolf Prize in Chemistry,754,Contenders,2002,1,20,chemistry,Middle
4631,1950,2,Hoover Medal,575,Contenders,1952,1,2,cs,Senior
4632,2005,14,Fellow of the Royal Society,1405,Contenders,2019,0,14,general,Middle
4633,2000,20,Nobel Prize in Physics,799,Contenders,2020,0,20,physics,Senior
4634,2001,19,Fellow of the Royal Society,496,Contenders,2020,0,19,general,Middle
4635,1983,31,Fellow of the Royal Society,135,Contenders,2014,1,31,general,Young
4636,1992,28,MacArthur Fellowship,416,Contenders,2020,0,28,general,Young
4637,2017,3,Max Planck Medal,1052,Contenders,2020,0,3,physics,Senior
4640,2003,14,National Medal of Science,77,Contenders,2017,1,14,general,Senior
4641,2004,15,Shanti Swarup Bhatnagar Prize for Science and Technology,817,Contenders,2019,0,15,general,Young
4642,1990,10,Shanti Swarup Bhatnagar Prize for Science and Technology,926,Contenders,2000,1,10,general,Young
4643,2005,15,Shanti Swarup Bhatnagar Prize for Science and Technology,663,Contenders,2020,0,15,general,Young
4645,1989,29,Nobel Prize in Chemistry,1130,Contenders,2018,0,29,chemistry,Middle
4646,2018,2,Breakthrough Prize in Life Sciences,624,Contenders,2020,0,2,biology,Middle
4647,2009,11,Shanti Swarup Bhatnagar Prize for Science and Technology,1394,Contenders,2020,0,11,general,Young
4648,1977,28,Fellow of the Royal Society,818,Contenders,2005,1,28,general,Young
4649,2014,5,Nobel Prize in Chemistry,87,Contenders,2019,0,5,chemistry,Middle
4650,2007,13,Fellow of the Royal Society,968,Contenders,2020,0,13,general,Senior
4651,1947,62,Nobel Prize in Physiology or Medicine,261,Contenders,2009,1,62,biology,Middle
4652,1980,19,Fellow of the Royal Society,1375,Contenders,1999,1,19,general,Young
4653,1976,24,National Medal of Science,1177,Contenders,2000,1,24,general,Senior
4655,1984,22,MacArthur Fellowship,998,Contenders,2006,1,22,general,Young
4656,1981,26,Fellow of the Royal Society,349,Contenders,2007,1,26,general,Middle
4657,1970,32,Max Planck Medal,942,Contenders,2002,1,32,physics,Middle
4658,1989,25,MacArthur Fellowship,802,Contenders,2014,1,25,general,Young
4659,2003,17,Shanti Swarup Bhatnagar Prize for Science and Technology,1163,Contenders,2020,0,17,general,Young
4660,1995,25,MacArthur Fellowship,129,Contenders,2020,0,25,general,Young
4662,1997,23,Shanti Swarup Bhatnagar Prize for Science and Technology,404,Contenders,2020,0,23,general,Young
4663,2016,4,Shanti Swarup Bhatnagar Prize for Science and Technology,603,Contenders,2020,0,4,general,NA
4664,1976,44,Fellow of the Royal Society,1298,Contenders,2020,0,44,general,Middle
4665,2006,14,Fellow of the Royal Society,247,Contenders,2020,0,14,general,NA
4666,2015,5,MacArthur Fellowship,972,Contenders,2020,0,5,general,NA
4668,1955,7,Willard Gibbs Award,1220,Contenders,1962,1,7,chemistry,Senior
4669,2017,3,Breakthrough Prize in Life Sciences,63,Contenders,2020,0,3,biology,Senior
4670,2011,9,Shanti Swarup Bhatnagar Prize for Science and Technology,1153,Contenders,2020,0,9,general,NA
4671,2005,14,Shanti Swarup Bhatnagar Prize for Science and Technology,113,Contenders,2019,0,14,general,Young
4672,1972,32,Davy Medal,306,Contenders,2004,1,32,chemistry,Middle
4673,2013,7,Fellow of the Royal Society,569,Contenders,2020,0,7,general,Middle
4674,2006,13,National Medal of Science,1420,Contenders,2019,0,13,general,Senior
4675,2015,4,Wolf Prize in Physics,298,Contenders,2019,0,4,physics,Senior
4676,1983,34,Fellow of the Royal Society,98,Contenders,2017,1,34,general,Young
4677,1982,37,MacArthur Fellowship,1225,Contenders,2019,0,37,general,Young
4678,2011,9,MacArthur Fellowship,786,Contenders,2020,0,9,general,Young
4679,1984,2,Nobel Prize in Physics,506,Contenders,1986,1,2,physics,Middle
4680,2012,6,Shanti Swarup Bhatnagar Prize for Science and Technology,468,Contenders,2018,0,6,general,Young
4681,1987,21,MacArthur Fellowship,872,Contenders,2008,1,21,general,NA
4682,2016,2,Fellow of the Royal Society,96,Contenders,2018,0,2,general,Middle
4683,2001,17,Wolf Prize in Mathematics,919,Contenders,2018,0,17,mathematics,Senior
4684,2006,13,Shanti Swarup Bhatnagar Prize for Science and Technology,1259,Contenders,2019,0,13,general,NA
4685,2009,9,Shanti Swarup Bhatnagar Prize for Science and Technology,10,Contenders,2018,0,9,general,NA
4686,2008,1,Nobel Prize in Chemistry,1338,Contenders,2009,1,1,chemistry,Senior
4687,2002,4,MacArthur Fellowship,315,Contenders,2006,1,4,general,Young
4688,2004,13,MacArthur Fellowship,136,Contenders,2017,1,13,general,Young
4689,2011,0,Fellow of the Royal Society,1369,Contenders,2011,1,0,general,Senior
4690,1966,16,Fields Medal,460,Contenders,1982,1,16,mathematics,Young
4691,2007,10,Hoover Medal,257,Contenders,2017,1,10,cs,Middle
4692,1992,17,Nobel Prize in Physiology or Medicine,677,Contenders,2009,1,17,biology,Senior
4693,2017,3,Fellow of the Royal Society,827,Contenders,2020,0,3,general,Middle
4694,2004,2,Nobel Prize in Chemistry,1341,Contenders,2006,1,2,chemistry,Senior
4695,2008,12,Fellow of the Royal Society,219,Contenders,2020,0,12,general,Young
4696,2002,11,MacArthur Fellowship,481,Contenders,2013,1,11,general,Young
4697,1974,30,Fellow of the Royal Society,316,Contenders,2004,1,30,general,Young
4698,1985,35,MacArthur Fellowship,1118,Contenders,2020,0,35,general,Middle
4699,1983,35,MacArthur Fellowship,748,Contenders,2018,0,35,general,Young
4700,1989,8,Shanti Swarup Bhatnagar Prize for Science and Technology,932,Contenders,1997,1,8,general,Young
4701,1999,21,Shanti Swarup Bhatnagar Prize for Science and Technology,302,Contenders,2020,0,21,general,Young
4703,1983,17,Shanti Swarup Bhatnagar Prize for Science and Technology,716,Contenders,2000,1,17,general,Young
4705,1993,0,MacArthur Fellowship,863,Contenders,1993,1,0,general,Young
4706,2017,3,Fellow of the Royal Society,1236,Contenders,2020,0,3,general,Senior
4707,2000,19,Fellow of the Royal Society,270,Contenders,2019,0,19,general,Senior
4710,2010,7,Fields Medal,543,Contenders,2017,1,7,mathematics,Young
4711,1978,30,Fields Medal,453,Contenders,2008,1,30,mathematics,Young
4712,1980,30,Fellow of the Royal Society,1447,Contenders,2010,1,30,general,Middle
4713,2013,7,MacArthur Fellowship,648,Contenders,2020,0,7,general,Senior
4714,1996,22,Nobel Prize in Physics,886,Contenders,2018,0,22,physics,Middle
4715,1936,38,Fields Medal,479,Contenders,1974,1,38,mathematics,Young
4716,1998,20,Fellow of the Royal Society,612,Contenders,2018,0,20,general,Young
4718,1997,23,Fellow of the Royal Society,729,Contenders,2020,0,23,general,Middle
4719,2013,7,SASTRA Ramanujan Prize,829,Contenders,2020,0,7,mathematics,Young
4721,1974,10,Fellow of the Royal Society,1465,Contenders,1984,1,10,general,Middle
4722,2000,19,MacArthur Fellowship,351,Contenders,2019,0,19,general,NA
4724,1972,8,Davy Medal,306,Contenders,1980,1,8,chemistry,Middle
4725,1980,4,Fellow of the Royal Society,1265,Contenders,1984,1,4,general,NA
4726,2013,7,Shanti Swarup Bhatnagar Prize for Science and Technology,540,Contenders,2020,0,7,general,Young
4727,2012,7,Shanti Swarup Bhatnagar Prize for Science and Technology,468,Contenders,2019,0,7,general,Young
4728,1988,3,MacArthur Fellowship,806,Contenders,1991,1,3,general,Young
4729,1976,33,Fellow of the Royal Society,1298,Contenders,2009,1,33,general,Middle
4730,1988,28,MacArthur Fellowship,806,Contenders,2016,1,28,general,Young
4731,2007,13,Fellow of the Royal Society,206,Contenders,2020,0,13,general,Young
4732,2001,11,MacArthur Fellowship,690,Contenders,2012,1,11,general,Middle
4736,2016,3,Fellow of the Royal Society,772,Contenders,2019,0,3,general,Young
4737,1981,10,Fellow of the Royal Society,1345,Contenders,1991,1,10,general,Middle
4738,1978,29,Fields Medal,453,Contenders,2007,1,29,mathematics,Young
4739,1998,22,MacArthur Fellowship,988,Contenders,2020,0,22,general,Young
4740,1988,28,MacArthur Fellowship,806,Contenders,2016,1,28,general,Young
4742,2008,11,Shanti Swarup Bhatnagar Prize for Science and Technology,105,Contenders,2019,0,11,general,Young
4743,1966,20,Fellow of the Royal Society,500,Contenders,1986,1,20,general,Middle
4744,2017,3,Fellow of the Royal Society,71,Contenders,2020,0,3,general,Middle
4745,1999,20,Fellow of the Royal Society,1390,Contenders,2019,0,20,general,Young
4746,1976,1,Marconi Prize,1031,Contenders,1977,1,1,cs,Middle
4747,2013,6,Fellow of the Royal Society,1410,Contenders,2019,0,6,general,Middle
4749,1999,21,Fellow of the Royal Society,42,Contenders,2020,0,21,general,Middle
4751,2006,14,Fellow of the Royal Society,356,Contenders,2020,0,14,general,Middle
4752,2001,2,Fellow of the Royal Society,658,Contenders,2003,1,2,general,Middle
4753,1975,1,Fellow of the Royal Society,169,Contenders,1976,1,1,general,Middle
4754,1999,18,Fellow of the Royal Society,254,Contenders,2017,1,18,general,Young
4755,1997,21,National Medal of Science,1323,Contenders,2018,0,21,general,Senior
4757,1968,10,Nobel Prize in Physiology or Medicine,290,Contenders,1978,1,10,biology,Middle
4758,1972,23,Fellow of the Royal Society,976,Contenders,1995,1,23,general,Middle
4759,1966,4,Fellow of the Royal Society,731,Contenders,1970,1,4,general,Young
4760,1966,4,Fellow of the Royal Society,1066,Contenders,1970,1,4,general,Young
4761,1985,9,Claude E. Shannon Award,1093,Contenders,1994,1,9,cs,Middle
4762,2007,13,Bigsby Medal,211,Contenders,2020,0,13,geography,Young
4763,1998,22,MacArthur Fellowship,988,Contenders,2020,0,22,general,Young
4764,2005,0,Fellow of the Royal Society,346,Contenders,2005,1,0,general,Middle
4767,1983,21,Fellow of the Royal Society,1214,Contenders,2004,1,21,general,Young
4769,1995,24,Shanti Swarup Bhatnagar Prize for Science and Technology,1182,Contenders,2019,0,24,general,Young
4770,1976,11,Hughes Medal,424,Contenders,1987,1,11,physics,Young
4771,1967,39,Nobel Prize in Chemistry,682,Contenders,2006,1,39,chemistry,Young
4772,1999,19,National Medal of Science,597,Contenders,2018,0,19,general,Senior
4774,1972,44,Fellow of the Royal Society,1451,Contenders,2016,1,44,general,Young
4775,2006,14,Shanti Swarup Bhatnagar Prize for Science and Technology,291,Contenders,2020,0,14,general,Young
4776,2004,16,Max Planck Medal,513,Contenders,2020,0,16,physics,Senior
4777,1954,3,Fellow of the Royal Society,14,Contenders,1957,1,3,general,Middle
4778,1982,10,MacArthur Fellowship,1225,Contenders,1992,1,10,general,Young
4779,1973,10,National Medal of Science,1376,Contenders,1983,1,10,general,Senior
4780,1980,12,Shanti Swarup Bhatnagar Prize for Science and Technology,1466,Contenders,1992,1,12,general,Young
4782,2000,15,Fellow of the Royal Society,1205,Contenders,2015,1,15,general,Middle
4783,1972,6,Shanti Swarup Bhatnagar Prize for Science and Technology,958,Contenders,1978,1,6,general,Young
4784,2003,17,Fellow of the Royal Society,789,Contenders,2020,0,17,general,Middle
4787,2005,14,Fellow of the Royal Society,738,Contenders,2019,0,14,general,Senior
4788,1985,2,Nobel Prize in Physics,940,Contenders,1987,1,2,physics,Young
4789,1982,24,Lasker-DeBakey Clinical Medical Research Award,378,Contenders,2006,1,24,biology,Middle
4790,1999,20,MacArthur Fellowship,1136,Contenders,2019,0,20,general,Young
4791,2009,1,Shanti Swarup Bhatnagar Prize for Science and Technology,1188,Contenders,2010,1,1,general,Young
4792,2006,13,Shanti Swarup Bhatnagar Prize for Science and Technology,470,Contenders,2019,0,13,general,Young
4795,1992,28,Fellow of the Royal Society,267,Contenders,2020,0,28,general,Young
4796,2005,14,Fellow of the Royal Society,1083,Contenders,2019,0,14,general,Middle
4797,2017,3,Fellow of the Royal Society,1101,Contenders,2020,0,3,general,Senior
4798,2002,16,Fellow of the Royal Society,1221,Contenders,2018,0,16,general,Middle
4799,1976,40,Nobel Prize in Physics,924,Contenders,2016,1,40,physics,Young
4800,1978,10,Fellow of the Royal Society,1184,Contenders,1988,1,10,general,Middle
4801,2017,3,Nobel Prize in Physics,308,Contenders,2020,0,3,physics,Senior
4802,1984,11,Shanti Swarup Bhatnagar Prize for Science and Technology,1292,Contenders,1995,1,11,general,Young
4803,2002,16,Fellow of the Royal Society,58,Contenders,2018,0,16,general,Middle
4804,1994,5,Shanti Swarup Bhatnagar Prize for Science and Technology,687,Contenders,1999,1,5,general,Young
4805,1991,3,Fellow of the Royal Society,980,Contenders,1994,1,3,general,Young
4807,1967,31,Fellow of the Royal Society,856,Contenders,1998,1,31,general,Young
4808,2002,18,Fellow of the Royal Society,1033,Contenders,2020,0,18,general,Middle
4809,2001,19,Fellow of the Royal Society,1210,Contenders,2020,0,19,general,Young
4810,2004,16,Fellow of the Royal Society,1209,Contenders,2020,0,16,general,Middle
4811,2006,14,Fellow of the Royal Society,11,Contenders,2020,0,14,general,Middle
4812,2010,10,National Medal of Science,281,Contenders,2020,0,10,general,Senior
4815,1972,13,Shanti Swarup Bhatnagar Prize for Science and Technology,958,Contenders,1985,1,13,general,Young
4816,1974,17,Shanti Swarup Bhatnagar Prize for Science and Technology,372,Contenders,1991,1,17,general,Young
4817,1995,7,Fellow of the Royal Society,602,Contenders,2002,1,7,general,Middle
4818,1989,28,Fellow of the Royal Society,524,Contenders,2017,1,28,general,Young
4819,1991,26,Nobel Prize in Physiology or Medicine,874,Contenders,2017,1,26,biology,Middle
4820,2004,16,Edison Medal,681,Contenders,2020,0,16,cs,Middle
4821,1994,10,Fellow of the Royal Society,376,Contenders,2004,1,10,general,Middle
4822,1987,24,National Medal of Science,755,Contenders,2011,1,24,general,Senior
4823,2005,14,Fellow of the Royal Society,29,Contenders,2019,0,14,general,Middle
4824,1994,15,National Medal of Science,221,Contenders,2009,1,15,general,Senior
4825,2009,6,Nobel Prize in Physiology or Medicine,345,Contenders,2015,1,6,biology,Middle
4826,2003,16,Shanti Swarup Bhatnagar Prize for Science and Technology,1000,Contenders,2019,0,16,general,Young
4827,1988,19,Shanti Swarup Bhatnagar Prize for Science and Technology,922,Contenders,2007,1,19,general,Young
4830,1984,29,Nobel Prize in Physics,506,Contenders,2013,1,29,physics,Middle
4831,1998,3,Wolf Prize in Medicine,565,Contenders,2001,1,3,biology,Senior
4833,1989,2,Fellow of the Royal Society,1171,Contenders,1991,1,2,general,Middle
4834,2003,13,MacArthur Fellowship,1362,Contenders,2016,1,13,general,Young
4837,1978,29,Nobel Prize in Physiology or Medicine,180,Contenders,2007,1,29,biology,Middle
4838,1996,22,Fellow of the Royal Society,850,Contenders,2018,0,22,general,Middle
4839,2014,6,Nobel Prize in Chemistry,87,Contenders,2020,0,6,chemistry,Middle
4840,2004,9,Nobel Prize in Physics,1349,Contenders,2013,1,9,physics,Middle
4841,2016,4,Fellow of the Royal Society,608,Contenders,2020,0,4,general,NA
4842,2018,2,Breakthrough Prize in Life Sciences,72,Contenders,2020,0,2,biology,Senior
4844,1965,3,Shanti Swarup Bhatnagar Prize for Science and Technology,1450,Contenders,1968,1,3,general,Young
4845,1986,27,MacArthur Fellowship,357,Contenders,2013,1,27,general,Young
4846,1982,14,National Medal of Science,883,Contenders,1996,1,14,general,Senior
4847,1994,9,Wolf Prize in Chemistry,894,Contenders,2003,1,9,chemistry,Young
4848,1937,45,Nobel Prize in Physiology or Medicine,1190,Contenders,1982,1,45,biology,Young
4850,1964,28,Fellow of the Royal Society,310,Contenders,1992,1,28,general,Middle
4851,1970,25,Fellow of the Royal Society,1081,Contenders,1995,1,25,general,Middle
4852,2018,2,Breakthrough Prize in Mathematics,13,Contenders,2020,0,2,mathematics,Middle
4853,1994,15,Fellow of the Royal Society,249,Contenders,2009,1,15,general,Young
4854,1985,10,Nobel Prize in Physics,940,Contenders,1995,1,10,physics,Young
4855,2015,4,Breakthrough Prize in Life Sciences,1020,Contenders,2019,0,4,biology,Middle
4856,1985,34,MacArthur Fellowship,627,Contenders,2019,0,34,general,Young
4858,1998,17,Fellow of the Royal Society,1314,Contenders,2015,1,17,general,Senior
4859,2008,11,Max Planck Medal,1366,Contenders,2019,0,11,physics,Senior
4860,2005,15,Fellow of the Royal Society,452,Contenders,2020,0,15,general,Senior
4861,1954,34,Fellow of the Royal Society,880,Contenders,1988,1,34,general,Young
4862,1982,6,National Medal of Science,883,Contenders,1988,1,6,general,Senior
4863,2011,9,MacArthur Fellowship,651,Contenders,2020,0,9,general,Young
4864,1999,20,Shanti Swarup Bhatnagar Prize for Science and Technology,1090,Contenders,2019,0,20,general,Young
4865,2008,12,MacArthur Fellowship,442,Contenders,2020,0,12,general,NA
4866,1951,2,Hughes Medal,1324,Contenders,1953,1,2,physics,Middle
4868,1991,18,Shanti Swarup Bhatnagar Prize for Science and Technology,150,Contenders,2009,1,18,general,Young
4869,2017,2,Nobel Prize in Physics,308,Contenders,2019,0,2,physics,Senior
4870,1994,24,Fellow of the Royal Society,293,Contenders,2018,0,24,general,Young
4871,1977,20,Fellow of the Royal Society,331,Contenders,1997,1,20,general,Middle
4873,2010,4,Nobel Prize in Chemistry,224,Contenders,2014,1,4,chemistry,Senior
4874,2002,17,Shanti Swarup Bhatnagar Prize for Science and Technology,734,Contenders,2019,0,17,general,Middle
4875,2017,3,Fellow of the Royal Society,461,Contenders,2020,0,3,general,Senior
4876,2016,4,Fellow of the Royal Society,33,Contenders,2020,0,4,general,Senior
4877,1997,23,National Medal of Science,911,Contenders,2020,0,23,general,Middle
4879,1982,4,Shanti Swarup Bhatnagar Prize for Science and Technology,650,Contenders,1986,1,4,general,Young
4880,2015,4,Fellow of the Royal Society,347,Contenders,2019,0,4,general,Middle
4881,1989,30,Shanti Swarup Bhatnagar Prize for Science and Technology,596,Contenders,2019,0,30,general,Young
4882,1994,18,Fellow of the Royal Society,1161,Contenders,2012,1,18,general,Young
4883,2004,4,Nobel Prize in Physics,1349,Contenders,2008,1,4,physics,Middle
4884,2017,1,Fellow of the Royal Society,1275,Contenders,2018,0,1,general,Middle
4885,2007,12,Turing Award,654,Contenders,2019,0,12,cs,Senior
4886,2001,18,MacArthur Fellowship,78,Contenders,2019,0,18,general,NA
4887,2004,15,MacArthur Fellowship,136,Contenders,2019,0,15,general,Young
4888,1996,22,Nobel Prize in Physics,1132,Contenders,2018,0,22,physics,Senior
4889,1993,23,Shanti Swarup Bhatnagar Prize for Science and Technology,640,Contenders,2016,1,23,general,Young
4890,1962,18,Fellow of the Royal Society,910,Contenders,1980,1,18,general,Young
4891,2004,16,Fellow of the Royal Society,804,Contenders,2020,0,16,general,Middle
4892,2002,14,Wolf Prize in Physics,809,Contenders,2016,1,14,physics,Senior
4894,1979,18,Fellow of the Royal Society,991,Contenders,1997,1,18,general,Middle
4895,1987,27,MacArthur Fellowship,1133,Contenders,2014,1,27,general,Middle
4896,2004,12,MacArthur Fellowship,136,Contenders,2016,1,12,general,Young
4897,2003,15,Fellow of the Royal Society,297,Contenders,2018,0,15,general,Senior
4898,1996,24,Fellow of the Royal Society,913,Contenders,2020,0,24,general,Middle
4899,2017,3,Fellow of the Royal Society,237,Contenders,2020,0,3,general,NA
4900,2017,2,Fellow of the Royal Society,897,Contenders,2019,0,2,general,Middle
4901,2003,0,Wollaston Medal,1134,Contenders,2003,1,0,geography,Senior
4902,2017,3,Fellow of the Royal Society,461,Contenders,2020,0,3,general,Senior
4903,1994,14,Fellow of the Royal Society,1168,Contenders,2008,1,14,general,Middle
4904,2011,9,National Medal of Science,1305,Contenders,2020,0,9,general,Senior
4905,2004,7,Max Planck Medal,513,Contenders,2011,1,7,physics,Senior
4906,2010,10,Shanti Swarup Bhatnagar Prize for Science and Technology,634,Contenders,2020,0,10,general,Young
4907,2016,4,Wolf Prize in Chemistry,1253,Contenders,2020,0,4,chemistry,Senior
4908,2016,3,Wolf Prize in Chemistry,1253,Contenders,2019,0,3,chemistry,Senior
4911,2016,4,Fellow of the Royal Society,33,Contenders,2020,0,4,general,Senior
4912,2014,2,Breakthrough Prize in Life Sciences,85,Contenders,2016,1,2,biology,Senior
4913,2016,0,Fellow of the Royal Society,532,Contenders,2016,1,0,general,Young
4914,1994,26,Wolf Prize in Chemistry,259,Contenders,2020,0,26,chemistry,Middle
4915,2007,13,National Medal of Science,965,Contenders,2020,0,13,general,Senior
4916,1993,25,Fellow of the Royal Society,704,Contenders,2018,0,25,general,Middle
4917,1981,12,MacArthur Fellowship,45,Contenders,1993,1,12,general,Young
4918,2010,9,Wolf Prize in Physics,1318,Contenders,2019,0,9,physics,Senior
4919,1998,20,Wolf Prize in Medicine,565,Contenders,2018,0,20,biology,Senior
4920,2012,7,Wolf Prize in Mathematics,262,Contenders,2019,0,7,mathematics,Senior
4921,2001,18,Shanti Swarup Bhatnagar Prize for Science and Technology,825,Contenders,2019,0,18,general,Young
4922,1997,8,National Medal of Science,1323,Contenders,2005,1,8,general,Senior
4923,2002,18,MacArthur Fellowship,574,Contenders,2020,0,18,general,Young
4924,1986,6,Fields Medal,1268,Contenders,1992,1,6,mathematics,Young
4926,2012,8,Shanti Swarup Bhatnagar Prize for Science and Technology,954,Contenders,2020,0,8,general,Young
4927,2014,6,Fields Medal,605,Contenders,2020,0,6,mathematics,Young
4928,1984,7,MacArthur Fellowship,166,Contenders,1991,1,7,general,Middle
4929,2017,1,Fellow of the Royal Society,1275,Contenders,2018,0,1,general,Middle
4930,2014,5,Wolf Prize in Medicine,530,Contenders,2019,0,5,biology,Senior
4931,1997,21,Shanti Swarup Bhatnagar Prize for Science and Technology,404,Contenders,2018,0,21,general,Young
4932,2000,19,Fellow of the Royal Society,1205,Contenders,2019,0,19,general,Middle
4933,1948,11,Fellow of the Royal Society,240,Contenders,1959,1,11,general,Middle
4934,2010,10,Fellow of the Royal Society,493,Contenders,2020,0,10,general,Middle
4935,1976,31,Hughes Medal,424,Contenders,2007,1,31,physics,Young
4936,1983,31,Fellow of the Royal Society,1094,Contenders,2014,1,31,general,Young
4937,1999,9,Fellow of the Royal Society,1228,Contenders,2008,1,9,general,NA
4938,2002,18,Turing Award,1091,Contenders,2020,0,18,cs,Middle
4939,1986,32,Fellow of the Royal Society,1448,Contenders,2018,0,32,general,Middle
4940,1986,27,Fellow of the Royal Society,1027,Contenders,2013,1,27,general,Middle
4941,2009,10,Lasker-DeBakey Clinical Medical Research Award,168,Contenders,2019,0,10,biology,Middle
4943,2000,3,MacArthur Fellowship,278,Contenders,2003,1,3,general,Young
4944,2017,3,Max Planck Medal,1052,Contenders,2020,0,3,physics,Senior
4945,1980,28,Fellow of the Royal Society,523,Contenders,2008,1,28,general,Young
4946,2006,10,MacArthur Fellowship,739,Contenders,2016,1,10,general,Young
4947,2014,3,Shanti Swarup Bhatnagar Prize for Science and Technology,1098,Contenders,2017,1,3,general,Young
4948,2016,1,Vautrin Lud Prize,1053,Contenders,2017,1,1,geography,Senior
4949,2017,0,Fellow of the Royal Society,237,Contenders,2017,1,0,general,NA
4950,1992,1,Fellow of the Royal Society,571,Contenders,1993,1,1,general,Middle
4951,1987,19,MacArthur Fellowship,464,Contenders,2006,1,19,general,Young
4952,1999,8,Fellow of the Royal Society,133,Contenders,2007,1,8,general,Senior
4953,2011,9,National Medal of Science,1311,Contenders,2020,0,9,general,Senior
4954,1999,20,MacArthur Fellowship,517,Contenders,2019,0,20,general,Young
4955,2015,5,Fellow of the Royal Society,901,Contenders,2020,0,5,general,Middle
4956,2014,5,Fellow of the Royal Society,373,Contenders,2019,0,5,general,Young
4959,2011,6,National Medal of Science,1311,Contenders,2017,1,6,general,Senior
4960,1979,4,Shanti Swarup Bhatnagar Prize for Science and Technology,1354,Contenders,1983,1,4,general,Young
4962,2012,7,Fellow of the Royal Society,819,Contenders,2019,0,7,general,Senior
4963,1985,13,MacArthur Fellowship,912,Contenders,1998,1,13,general,Young
4965,1967,0,Albert Einstein Award,824,Contenders,1967,1,0,physics,Young
4966,1989,0,Shanti Swarup Bhatnagar Prize for Science and Technology,502,Contenders,1989,1,0,general,Young
4967,2002,18,MacArthur Fellowship,62,Contenders,2020,0,18,general,Young
4968,1979,18,National Medal of Science,1151,Contenders,1997,1,18,general,Middle
4969,2002,17,Shanti Swarup Bhatnagar Prize for Science and Technology,1023,Contenders,2019,0,17,general,Young
4970,1964,1,Fellow of the Royal Society,1389,Contenders,1965,1,1,general,Young
4971,2001,6,Wolf Prize in Mathematics,919,Contenders,2007,1,6,mathematics,Senior
4973,1901,14,Fellow of the Royal Society,706,Contenders,1915,1,14,general,Young
4974,1994,14,Fellow of the Royal Society,664,Contenders,2008,1,14,general,Young
4975,1996,22,Fellow of the Royal Society,335,Contenders,2018,0,22,general,Middle
4976,1989,29,Nobel Prize in Physiology or Medicine,1276,Contenders,2018,0,29,biology,Middle
4977,1993,25,Nobel Prize in Physiology or Medicine,776,Contenders,2018,0,25,biology,Middle
4978,1978,41,Wolf Prize in Medicine,1391,Contenders,2019,0,41,biology,Middle
4979,2011,5,National Medal of Science,1311,Contenders,2016,1,5,general,Senior
4980,1987,18,Nobel Prize in Physiology or Medicine,36,Contenders,2005,1,18,biology,Middle
4981,1968,41,Fellow of the Royal Society,967,Contenders,2009,1,41,general,Young
4982,2003,6,Wollaston Medal,1134,Contenders,2009,1,6,geography,Senior
4983,1989,14,National Medal of Science,830,Contenders,2003,1,14,general,Senior
4984,2009,11,Fellow of the Royal Society,475,Contenders,2020,0,11,general,NA
4985,2006,13,Fellow of the Royal Society,599,Contenders,2019,0,13,general,Young
4986,2005,9,Fellow of the Royal Society,1069,Contenders,2014,1,9,general,Middle
4987,2012,7,Fellow of the Royal Society,184,Contenders,2019,0,7,general,Middle
4988,2000,14,Marconi Prize,1206,Contenders,2014,1,14,cs,Middle
4989,1988,31,Nobel Prize in Chemistry,969,Contenders,2019,0,31,chemistry,Middle
4990,2015,5,Fellow of the Royal Society,1290,Contenders,2020,0,5,general,NA
4991,2007,12,Fellow of the Royal Society,558,Contenders,2019,0,12,general,Middle
4992,1999,21,Fellow of the Royal Society,101,Contenders,2020,0,21,general,Middle
4993,2006,9,MacArthur Fellowship,685,Contenders,2015,1,9,general,Young
4994,1984,25,Wolf Prize in Medicine,469,Contenders,2009,1,25,biology,Middle
4995,2007,12,Fellow of the Royal Society,387,Contenders,2019,0,12,general,Middle
4996,2009,11,Lasker-DeBakey Clinical Medical Research Award,670,Contenders,2020,0,11,biology,Middle
4997,1995,11,Fellow of the Royal Society,1308,Contenders,2006,1,11,general,Middle
4998,2007,12,Fellow of the Royal Society,968,Contenders,2019,0,12,general,Senior
4999,2012,7,Fellow of the Royal Society,962,Contenders,2019,0,7,general,Senior
5000,2015,5,Fellow of the Royal Society,322,Contenders,2020,0,5,general,NA
5001,1984,36,Fellow of the Royal Society,20,Contenders,2020,0,36,general,Young
5002,1987,33,Wolf Prize in Medicine,6,Contenders,2020,0,33,biology,Middle
5003,1989,31,Nobel Prize in Chemistry,80,Contenders,2020,0,31,chemistry,Young
5004,2001,19,Fellow of the Royal Society,443,Contenders,2020,0,19,general,Middle
5005,2015,5,Fellow of the Royal Society,766,Contenders,2020,0,5,general,NA
5006,2000,20,MacArthur Fellowship,775,Contenders,2020,0,20,general,Young
5007,2008,11,National Medal of Science,858,Contenders,2019,0,11,general,Senior
5008,1998,20,Lasker-DeBakey Clinical Medical Research Award,1003,Contenders,2018,0,20,biology,Senior
5009,1999,20,Fellow of the Royal Society,409,Contenders,2019,0,20,general,Middle
5010,2009,8,Nobel Prize in Physics,1197,Contenders,2017,1,8,physics,Senior
5011,2001,2,Fellow of the Royal Society,76,Contenders,2003,1,2,general,Middle
5012,1982,1,MacArthur Fellowship,728,Contenders,1983,1,1,general,Young
5013,2013,7,Breakthrough Prize in Life Sciences,759,Contenders,2020,0,7,biology,Middle
5014,2001,19,Fellow of the Royal Society,128,Contenders,2020,0,19,general,Middle
5015,1975,42,Nobel Prize in Physiology or Medicine,1396,Contenders,2017,1,42,biology,Young
5016,1989,28,Nobel Prize in Physiology or Medicine,155,Contenders,2017,1,28,biology,Middle
5017,2001,19,National Medal of Science,694,Contenders,2020,0,19,general,Senior
5018,2017,3,Fellow of the Royal Society,320,Contenders,2020,0,3,general,Middle
5019,2014,6,Fellow of the Royal Society,985,Contenders,2020,0,6,general,Young
5020,1999,18,MacArthur Fellowship,1136,Contenders,2017,1,18,general,Young
5021,1987,33,Fellow of the Royal Society,859,Contenders,2020,0,33,general,Middle
5022,2007,13,Fellow of the Royal Society,1312,Contenders,2020,0,13,general,Middle
5023,2012,7,Fellow of the Royal Society,1068,Contenders,2019,0,7,general,Senior
5024,2008,11,Shanti Swarup Bhatnagar Prize for Science and Technology,623,Contenders,2019,0,11,general,Young
5025,2003,16,Shanti Swarup Bhatnagar Prize for Science and Technology,938,Contenders,2019,0,16,general,Young
5026,2006,14,MacArthur Fellowship,458,Contenders,2020,0,14,general,Middle
5027,1995,21,Marconi Prize,246,Contenders,2016,1,21,cs,Senior
5028,1994,22,Fields Medal,340,Contenders,2016,1,22,mathematics,Young
5029,1985,33,Fellow of the Royal Society,828,Contenders,2018,0,33,general,Senior
5030,1964,7,Nobel Prize in Physics,1334,Contenders,1971,1,7,physics,Middle
5031,1993,22,Fellow of the Royal Society,143,Contenders,2015,1,22,general,Middle
5032,2010,10,MacArthur Fellowship,122,Contenders,2020,0,10,general,Young
5033,2001,19,Fellow of the Royal Society,643,Contenders,2020,0,19,general,NA
5034,2013,7,National Medal of Science,947,Contenders,2020,0,7,general,Senior
5035,2001,8,Fellow of the Royal Society,1385,Contenders,2009,1,8,general,Middle
5036,2005,4,Fellow of the Royal Society,346,Contenders,2009,1,4,general,Middle
5037,1993,0,MacArthur Fellowship,863,Contenders,1993,1,0,general,Young
5038,1987,33,Fellow of the Royal Society,183,Contenders,2020,0,33,general,Middle
5039,1978,32,Fields Medal,453,Contenders,2010,1,32,mathematics,Young
5040,2005,12,Fellow of the Royal Society,937,Contenders,2017,1,12,general,NA
5041,1983,37,Fellow of the Royal Society,98,Contenders,2020,0,37,general,Young
5042,1959,25,Shanti Swarup Bhatnagar Prize for Science and Technology,814,Contenders,1984,1,25,general,Young
5043,1976,10,Fellow of the Royal Society,945,Contenders,1986,1,10,general,Young
5044,1990,2,Wolf Prize in Physics,93,Contenders,1992,1,2,physics,Middle
5045,1982,30,Lasker-DeBakey Clinical Medical Research Award,592,Contenders,2012,1,30,biology,Middle
5046,2006,13,MacArthur Fellowship,685,Contenders,2019,0,13,general,Young
5047,1998,17,Wolf Prize in Physics,48,Contenders,2015,1,17,physics,Senior
5048,1985,34,Fellow of the Royal Society,1145,Contenders,2019,0,34,general,Middle
5049,2016,4,Shanti Swarup Bhatnagar Prize for Science and Technology,736,Contenders,2020,0,4,general,Young
5050,1992,28,Shanti Swarup Bhatnagar Prize for Science and Technology,177,Contenders,2020,0,28,general,Young
5051,1996,11,Willard Gibbs Award,467,Contenders,2007,1,11,chemistry,Senior
5052,2007,13,Fellow of the Royal Society,380,Contenders,2020,0,13,general,Middle
5053,1982,38,Fields Medal,1141,Contenders,2020,0,38,mathematics,Young
5054,1959,27,Shanti Swarup Bhatnagar Prize for Science and Technology,814,Contenders,1986,1,27,general,Young
5056,1991,29,Nobel Prize in Physiology or Medicine,161,Contenders,2020,0,29,biology,Middle
5057,2007,13,Fellow of the Royal Society,712,Contenders,2020,0,13,general,Senior
5058,2018,2,Fellow of the Royal Society,286,Contenders,2020,0,2,general,Senior
5059,1987,32,MacArthur Fellowship,613,Contenders,2019,0,32,general,Middle
5060,2016,4,Fellow of the Royal Society,528,Contenders,2020,0,4,general,NA
5061,2009,10,Wollaston Medal,1296,Contenders,2019,0,10,geography,Senior
5062,2003,17,MacArthur Fellowship,106,Contenders,2020,0,17,general,Young
5063,2011,9,Nobel Prize in Physiology or Medicine,1297,Contenders,2020,0,9,biology,Middle
5064,1988,29,Fellow of the Royal Society,997,Contenders,2017,1,29,general,Middle
5065,1999,16,Fellow of the Royal Society,409,Contenders,2015,1,16,general,Middle
5066,1992,25,Fellow of the Royal Society,89,Contenders,2017,1,25,general,Senior
5068,1989,24,Shanti Swarup Bhatnagar Prize for Science and Technology,932,Contenders,2013,1,24,general,Young
5069,1986,33,MacArthur Fellowship,595,Contenders,2019,0,33,general,Young
5070,2008,12,Fellow of the Royal Society,447,Contenders,2020,0,12,general,Middle
5071,1990,29,Fellow of the Royal Society,758,Contenders,2019,0,29,general,Young
5072,1985,33,Willard Gibbs Award,154,Contenders,2018,0,33,chemistry,Senior
5073,1990,28,National Medal of Science,1363,Contenders,2018,0,28,general,Senior
5074,2014,5,Nobel Prize in Physiology or Medicine,905,Contenders,2019,0,5,biology,Senior
5075,2006,13,National Medal of Science,1165,Contenders,2019,0,13,general,Senior
5076,2002,15,Shanti Swarup Bhatnagar Prize for Science and Technology,1023,Contenders,2017,1,15,general,Young
5077,1998,18,Fellow of the Royal Society,88,Contenders,2016,1,18,general,Middle
5078,2009,11,MacArthur Fellowship,844,Contenders,2020,0,11,general,Young
5079,1992,26,MacArthur Fellowship,273,Contenders,2018,0,26,general,Middle
5080,1988,31,Nobel Prize in Chemistry,969,Contenders,2019,0,31,chemistry,Middle
5081,1994,25,Wolf Prize in Chemistry,259,Contenders,2019,0,25,chemistry,Middle
5082,1997,15,Shanti Swarup Bhatnagar Prize for Science and Technology,341,Contenders,2012,1,15,general,Young
5084,1984,32,MacArthur Fellowship,1080,Contenders,2016,1,32,general,Young
5085,2001,14,Shanti Swarup Bhatnagar Prize for Science and Technology,108,Contenders,2015,1,14,general,Young
5086,2005,15,Fellow of the Royal Society,878,Contenders,2020,0,15,general,Senior
5087,2018,2,Breakthrough Prize in Life Sciences,590,Contenders,2020,0,2,biology,Senior
5088,1996,24,Shanti Swarup Bhatnagar Prize for Science and Technology,1250,Contenders,2020,0,24,general,Young
5089,1982,25,Willard Gibbs Award,1422,Contenders,2007,1,25,chemistry,Senior
5090,2009,4,Shanti Swarup Bhatnagar Prize for Science and Technology,10,Contenders,2013,1,4,general,NA
5091,2011,3,Max Planck Medal,1019,Contenders,2014,1,3,physics,Senior
5092,1983,33,Fellow of the Royal Society,370,Contenders,2016,1,33,general,Young
5093,2011,1,MacArthur Fellowship,835,Contenders,2012,1,1,general,Young
5094,2012,0,Fellow of the Royal Society,371,Contenders,2012,1,0,general,Young
5095,2005,14,Fellow of the Royal Society,95,Contenders,2019,0,14,general,Middle
5096,2009,11,Fellow of the Royal Society,539,Contenders,2020,0,11,general,NA
5097,1987,24,MacArthur Fellowship,1322,Contenders,2011,1,24,general,Young
5098,1984,36,Fellow of the Royal Society,1232,Contenders,2020,0,36,general,Middle
5099,2016,4,Breakthrough Prize in Life Sciences,66,Contenders,2020,0,4,biology,Senior
5100,2015,4,Fellow of the Royal Society,347,Contenders,2019,0,4,general,Middle
5101,2017,2,Fellow of the Royal Society,1233,Contenders,2019,0,2,general,Senior
5102,2011,6,Fellow of the Royal Society,55,Contenders,2017,1,6,general,Middle
5103,2018,2,Bigsby Medal,672,Contenders,2020,0,2,geography,NA
5104,1990,30,Fellow of the Royal Society,158,Contenders,2020,0,30,general,Middle
5105,2001,19,National Medal of Science,1310,Contenders,2020,0,19,general,Senior
5106,1998,22,MacArthur Fellowship,1157,Contenders,2020,0,22,general,Middle
5107,2013,7,MacArthur Fellowship,840,Contenders,2020,0,7,general,Young
5108,2010,9,Fields Medal,920,Contenders,2019,0,9,mathematics,Young
5109,1985,34,Fellow of the Royal Society,692,Contenders,2019,0,34,general,Young
5110,1994,11,Nobel Prize in Physiology or Medicine,1344,Contenders,2005,1,11,biology,Middle
5112,2015,0,Wolf Prize in Medicine,186,Contenders,2015,1,0,biology,Senior
5113,2002,9,National Medal of Science,426,Contenders,2011,1,9,general,Senior
5114,2010,4,National Medal of Science,407,Contenders,2014,1,4,general,Senior
5115,1972,16,Fellow of the Royal Society,1451,Contenders,1988,1,16,general,Young
5116,2016,4,Fellow of the Royal Society,268,Contenders,2020,0,4,general,Middle
5117,1997,22,Fellow of the Royal Society,3,Contenders,2019,0,22,general,Middle
5118,1994,25,Fellow of the Royal Society,377,Contenders,2019,0,25,general,Young
5119,1999,19,Fellow of the Royal Society,511,Contenders,2018,0,19,general,Middle
5120,1984,35,Fellow of the Royal Society,1232,Contenders,2019,0,35,general,Middle
5121,2013,7,MacArthur Fellowship,64,Contenders,2020,0,7,general,Middle
5122,1983,26,Wolf Prize in Chemistry,1008,Contenders,2009,1,26,chemistry,Middle
5123,2011,8,National Medal of Science,644,Contenders,2019,0,8,general,Senior
5124,2003,16,MacArthur Fellowship,977,Contenders,2019,0,16,general,Middle
5125,2000,20,Fellow of the Royal Society,720,Contenders,2020,0,20,general,NA
5126,2013,7,MacArthur Fellowship,840,Contenders,2020,0,7,general,Young
5127,2000,20,Nobel Prize in Chemistry,637,Contenders,2020,0,20,chemistry,Senior
5128,2011,9,Nobel Prize in Physiology or Medicine,444,Contenders,2020,0,9,biology,Senior
5129,1982,26,Shanti Swarup Bhatnagar Prize for Science and Technology,845,Contenders,2008,1,26,general,Young
5130,2017,3,Wolf Prize in Physics,1261,Contenders,2020,0,3,physics,Middle
5132,2003,16,Fellow of the Royal Society,489,Contenders,2019,0,16,general,Senior
5133,1994,19,National Medal of Science,1463,Contenders,2013,1,19,general,Senior
5134,2003,12,National Medal of Science,203,Contenders,2015,1,12,general,Senior
5135,2016,4,Fellow of the Royal Society,1076,Contenders,2020,0,4,general,Senior
5136,2010,10,Shanti Swarup Bhatnagar Prize for Science and Technology,923,Contenders,2020,0,10,general,Young
5137,1988,18,Fellow of the Royal Society,997,Contenders,2006,1,18,general,Middle
5138,2009,11,National Medal of Science,928,Contenders,2020,0,11,general,Middle
5139,2016,4,Breakthrough Prize in Life Sciences,66,Contenders,2020,0,4,biology,Senior
5140,2012,8,Fellow of the Royal Society,747,Contenders,2020,0,8,general,Middle
5141,2015,4,Breakthrough Prize in Life Sciences,422,Contenders,2019,0,4,biology,Senior
5142,1988,17,National Medal of Science,552,Contenders,2005,1,17,general,Senior
5143,1979,41,Fellow of the Royal Society,1216,Contenders,2020,0,41,general,Young
5144,1988,32,Wolf Prize in Chemistry,836,Contenders,2020,0,32,chemistry,Middle
5145,1972,45,Fellow of the Royal Society,1114,Contenders,2017,1,45,general,Young
5146,1985,30,Fellow of the Royal Society,1135,Contenders,2015,1,30,general,Middle
5147,2009,10,MacArthur Fellowship,1437,Contenders,2019,0,10,general,Young
5148,1974,46,Fellow of the Royal Society,1465,Contenders,2020,0,46,general,Middle
5150,2004,16,Fellow of the Royal Society,31,Contenders,2020,0,16,general,Middle
5151,2004,16,Fellow of the Royal Society,1011,Contenders,2020,0,16,general,Middle
5152,2011,7,National Medal of Science,1305,Contenders,2018,0,7,general,Senior
5154,1989,20,Fellow of the Royal Society,348,Contenders,2009,1,20,general,Young
5155,1991,28,MacArthur Fellowship,547,Contenders,2019,0,28,general,Young
5156,2013,7,Fellow of the Royal Society,1115,Contenders,2020,0,7,general,Middle
5157,2015,4,Vautrin Lud Prize,295,Contenders,2019,0,4,geography,Senior
5158,1986,1,Shanti Swarup Bhatnagar Prize for Science and Technology,115,Contenders,1987,1,1,general,Young
5159,1998,21,MacArthur Fellowship,884,Contenders,2019,0,21,general,Young
5160,2017,3,Wolf Prize in Physics,1261,Contenders,2020,0,3,physics,Middle
5161,1989,31,Fellow of the Royal Society,399,Contenders,2020,0,31,general,Young
5162,1992,28,Fellow of the Royal Society,557,Contenders,2020,0,28,general,Middle
5163,2010,9,Fields Medal,40,Contenders,2019,0,9,mathematics,Young
5164,1984,30,Fellow of the Royal Society,1126,Contenders,2014,1,30,general,Young
5166,1987,33,MacArthur Fellowship,266,Contenders,2020,0,33,general,Young
5167,2001,19,National Medal of Science,1310,Contenders,2020,0,19,general,Senior
5168,2007,13,Fellow of the Royal Society,27,Contenders,2020,0,13,general,Young
5169,1991,17,Fellow of the Royal Society,488,Contenders,2008,1,17,general,Young
5170,2006,14,Fellow of the Royal Society,855,Contenders,2020,0,14,general,Middle
5171,2012,7,Fellow of the Royal Society,184,Contenders,2019,0,7,general,Middle
5172,2005,12,Turing Award,125,Contenders,2017,1,12,cs,Senior
5173,2012,8,Nobel Prize in Chemistry,167,Contenders,2020,0,8,chemistry,Middle
5174,1998,20,Fellow of the Royal Society,1287,Contenders,2018,0,20,general,NA
5175,1995,24,MacArthur Fellowship,925,Contenders,2019,0,24,general,Middle
5176,1999,17,Fellow of the Royal Society,254,Contenders,2016,1,17,general,Young
5177,2011,8,National Medal of Science,551,Contenders,2019,0,8,general,Senior
5178,1999,10,Fellow of the Royal Society,609,Contenders,2009,1,10,general,Middle
5179,2004,15,Fellow of the Royal Society,1209,Contenders,2019,0,15,general,Middle
5180,2001,19,MacArthur Fellowship,367,Contenders,2020,0,19,general,NA
5181,1983,37,MacArthur Fellowship,120,Contenders,2020,0,37,general,Young
5182,2017,3,Fellow of the Royal Society,769,Contenders,2020,0,3,general,NA
5183,1995,21,Shanti Swarup Bhatnagar Prize for Science and Technology,979,Contenders,2016,1,21,general,Young
5185,1998,12,Fellow of the Royal Society,88,Contenders,2010,1,12,general,Middle
5186,2014,5,Fellow of the Royal Society,255,Contenders,2019,0,5,general,Senior
5187,1985,35,Fellow of the Royal Society,1087,Contenders,2020,0,35,general,Middle
5188,1974,34,Fellow of the Royal Society,220,Contenders,2008,1,34,general,Young
5189,2005,14,Nobel Prize in Chemistry,359,Contenders,2019,0,14,chemistry,Senior
5190,2010,9,National Medal of Science,407,Contenders,2019,0,9,general,Senior
5191,1996,24,Shanti Swarup Bhatnagar Prize for Science and Technology,383,Contenders,2020,0,24,general,Young
5192,1994,16,Wolf Prize in Chemistry,259,Contenders,2010,1,16,chemistry,Middle
5193,1986,34,National Medal of Science,1131,Contenders,2020,0,34,general,Middle
5194,1986,11,Fellow of the Royal Society,1392,Contenders,1997,1,11,general,Young
5195,1987,10,Fellow of the Royal Society,621,Contenders,1997,1,10,general,Middle
5196,1989,18,National Medal of Science,501,Contenders,2007,1,18,general,Middle
5197,1982,36,Wollaston Medal,258,Contenders,2018,0,36,geography,Middle
5198,2004,14,National Medal of Science,1111,Contenders,2018,0,14,general,Senior
5199,2000,18,Shanti Swarup Bhatnagar Prize for Science and Technology,418,Contenders,2018,0,18,general,NA
5200,1991,17,National Medal of Science,1400,Contenders,2008,1,17,general,Senior
5201,2006,13,Shanti Swarup Bhatnagar Prize for Science and Technology,1166,Contenders,2019,0,13,general,Young
5202,1992,28,Fellow of the Royal Society,318,Contenders,2020,0,28,general,Young
5203,1995,24,Shanti Swarup Bhatnagar Prize for Science and Technology,1182,Contenders,2019,0,24,general,Young
5204,2004,16,Fellow of the Royal Society,804,Contenders,2020,0,16,general,Middle
5205,2007,4,Fellow of the Royal Society,1143,Contenders,2011,1,4,general,NA
5206,1999,21,MacArthur Fellowship,719,Contenders,2020,0,21,general,NA
5207,2002,18,Fellow of the Royal Society,1221,Contenders,2020,0,18,general,Middle
5208,2007,13,Shanti Swarup Bhatnagar Prize for Science and Technology,1041,Contenders,2020,0,13,general,Young
5209,1974,32,Shanti Swarup Bhatnagar Prize for Science and Technology,372,Contenders,2006,1,32,general,Young
5210,1988,26,Fellow of the Royal Society,1395,Contenders,2014,1,26,general,Young
5211,1963,20,Fellow of the Royal Society,1159,Contenders,1983,1,20,general,Young
5212,2007,10,Turing Award,722,Contenders,2017,1,10,cs,Middle
5213,2001,7,National Medal of Science,694,Contenders,2008,1,7,general,Senior
5214,2002,17,Fellow of the Royal Society,58,Contenders,2019,0,17,general,Middle
5215,2009,9,Shanti Swarup Bhatnagar Prize for Science and Technology,1449,Contenders,2018,0,9,general,NA
5216,2013,7,Fellow of the Royal Society,569,Contenders,2020,0,7,general,Middle
5217,2006,13,Fellow of the Royal Society,1431,Contenders,2019,0,13,general,NA
5218,2011,8,Fellow of the Royal Society,55,Contenders,2019,0,8,general,Middle
5219,2004,15,Fellow of the Royal Society,31,Contenders,2019,0,15,general,Middle
5220,1997,4,Nobel Prize in Physics,903,Contenders,2001,1,4,physics,Middle
5221,1999,18,Copley Medal,785,Contenders,2017,1,18,general,Senior
5222,2000,20,Fellow of the Royal Society,726,Contenders,2020,0,20,general,Young
5223,2005,15,Fellow of the Royal Society,29,Contenders,2020,0,15,general,Middle
5224,2015,4,Breakthrough Prize in Life Sciences,422,Contenders,2019,0,4,biology,Senior
5225,2011,9,National Medal of Science,644,Contenders,2020,0,9,general,Senior
5226,1986,28,Wolf Prize in Chemistry,232,Contenders,2014,1,28,chemistry,Senior
5227,1987,33,MacArthur Fellowship,526,Contenders,2020,0,33,general,Young
5228,2001,18,MacArthur Fellowship,367,Contenders,2019,0,18,general,NA
5229,2007,12,Fellow of the Royal Society,953,Contenders,2019,0,12,general,Senior
5230,2002,15,Wollaston Medal,1240,Contenders,2017,1,15,geography,Senior
5231,1999,13,Fellow of the Royal Society,1002,Contenders,2012,1,13,general,Senior
5232,2002,17,National Medal of Science,426,Contenders,2019,0,17,general,Senior
5233,1983,24,MacArthur Fellowship,120,Contenders,2007,1,24,general,Young
5234,1988,26,Fellow of the Royal Society,201,Contenders,2014,1,26,general,Middle
5235,1995,17,Fellow of the Royal Society,121,Contenders,2012,1,17,general,Middle
5236,1996,24,Nobel Prize in Physiology or Medicine,100,Contenders,2020,0,24,biology,Middle
5237,1983,23,Fellow of the Royal Society,135,Contenders,2006,1,23,general,Young
5238,1936,73,Fields Medal,479,Contenders,2009,1,73,mathematics,Young
5239,2015,5,MacArthur Fellowship,972,Contenders,2020,0,5,general,NA
5240,2014,6,Fellow of the Royal Society,94,Contenders,2020,0,6,general,Middle
5241,1998,21,Lasker-DeBakey Clinical Medical Research Award,209,Contenders,2019,0,21,biology,Senior
5242,1987,22,MacArthur Fellowship,1289,Contenders,2009,1,22,general,Young
5243,1974,13,Nobel Prize in Physiology or Medicine,289,Contenders,1987,1,13,biology,Middle
